meetings that start later than the weekly standup meeting	 (listValue (filter (getProperty (singleton en.meeting) (string !type)) (ensureNumericProperty (string start_time)) (string >) (ensureNumericEntity (getProperty en.meeting.weekly_standup (string end_time)))))
what date is the weekly standup meeting	 (listValue (getProperty en.meeting.weekly_standup (string date)))
when is the weekly standup	 (listValue (getProperty en.meeting.weekly_standup (string start_time)))
show me all meetings in greenberg cafe that alice is attending	 (listValue (filter (filter (getProperty (singleton en.meeting) (string !type)) (string location) (string =) en.location.greenberg_cafe) (string attendee) (string =) en.person.alice))
show me the meeting starting latest in the day	 (listValue (superlative (getProperty (singleton en.meeting) (string !type)) (string max) (ensureNumericProperty (string start_time))))
show me all meetings not ending at 10 am	 (listValue (filter (getProperty (singleton en.meeting) (string !type)) (string end_time) (string !=) (time 10 0)))
show me all meetings with at least two people attending	 (listValue (countComparative (getProperty (singleton en.meeting) (string !type)) (string attendee) (string >=) (number 2)))
show me all meetings lasting for three hours	 (listValue (filter (filter (getProperty (singleton en.meeting) (string !type)) (string length) (string =) (number 3 en.hour)) (string length) (string =) (number 3 en.hour)))
meetings that start before 10am or before 3pm	 (listValue (filter (getProperty (singleton en.meeting) (string !type)) (ensureNumericProperty (string start_time)) (string <) (ensureNumericEntity (concat (time 10 0) (time 15 0)))))
which meetings dont start at 10am	 (listValue (filter (getProperty (singleton en.meeting) (string !type)) (string start_time) (string !=) (time 10 0)))
what meeting ends before the start of weekly standup	 (listValue (filter (getProperty (singleton en.meeting) (string !type)) (ensureNumericProperty (string end_time)) (string <) (ensureNumericEntity (getProperty en.meeting.weekly_standup (string start_time)))))
show me meetings after jan 2	 (listValue (filter (getProperty (singleton en.meeting) (string !type)) (ensureNumericProperty (string date)) (string >) (ensureNumericEntity (concat (date 2015 1 2) (date 2015 1 3)))))
what meeting has the earliest start time	 (listValue (superlative (getProperty (singleton en.meeting) (string !type)) (string min) (ensureNumericProperty (string start_time))))
show me all meetings three hours long at the greenberg cafe	 (listValue (filter (filter (getProperty (singleton en.meeting) (string !type)) (string length) (string =) (number 3 en.hour)) (string location) (string =) en.location.greenberg_cafe))
show me all meetings ending no later than 10 am	 (listValue (filter (getProperty (singleton en.meeting) (string !type)) (ensureNumericProperty (string end_time)) (string <=) (ensureNumericEntity (time 10 0))))
important meeting on january 2nd	 (listValue (filter (filter (getProperty (singleton en.meeting) (string !type)) (string is_important)) (string date) (string =) (date 2015 1 2)))
show me all meetings that begin no later than the time the weekly standup meeting starts	 (listValue (filter (getProperty (singleton en.meeting) (string !type)) (ensureNumericProperty (string start_time)) (string <=) (ensureNumericEntity (getProperty en.meeting.weekly_standup (string start_time)))))
how long is the weekly standup meeting	 (listValue (getProperty en.meeting.weekly_standup (string length)))
show me all 3 hour long meetings that end at 10am	 (listValue (filter (filter (getProperty (singleton en.meeting) (string !type)) (string end_time) (string =) (time 10 0)) (string length) (string =) (number 3 en.hour)))
show me all meetings not beginning at 10 am	 (listValue (filter (getProperty (singleton en.meeting) (string !type)) (string start_time) (string !=) (time 10 0)))
which meetings end when weekly standup is scheduled to start	 (listValue (filter (getProperty (singleton en.meeting) (string !type)) (string end_time) (string =) (getProperty en.meeting.weekly_standup (string start_time))))
show me all locations which have had at least two meetings	 (listValue (countComparative (getProperty (singleton en.location) (string !type)) (reverse (string location)) (string >=) (number 2) (getProperty (singleton en.meeting) (string !type))))
show me meetings that take 3 hours	 (listValue (filter (filter (getProperty (singleton en.meeting) (string !type)) (string length) (string =) (number 3 en.hour)) (string length) (string =) (number 3 en.hour)))
what meeting had the fewest people show up	 (listValue (countSuperlative (getProperty (singleton en.meeting) (string !type)) (string min) (string attendee)))
what time does the weekly stand up end	 (listValue (getProperty en.meeting.weekly_standup (string end_time)))
what meeting ends at 10am and alice is attending	 (listValue (filter (filter (getProperty (singleton en.meeting) (string !type)) (string attendee) (string =) en.person.alice) (string end_time) (string =) (time 10 0)))
show me average meeting length	 (listValue (aggregate (string avg) (getProperty (getProperty (singleton en.meeting) (string !type)) (string length))))
person attending jan 2nd meeting	 (listValue (filter (getProperty (singleton en.person) (string !type)) (reverse (string attendee)) (string =) (filter (getProperty (singleton en.meeting) (string !type)) (string date) (string =) (date 2015 1 2))))
show me all meetings with either bob or alice attending	 (listValue (filter (getProperty (singleton en.meeting) (string !type)) (string attendee) (string =) (concat en.person.alice en.person.bob)))
show me meetings that have two attendees	 (listValue (countComparative (getProperty (singleton en.meeting) (string !type)) (string attendee) (string =) (number 2)))
show me all meetings ending at the same time or earlier than the weekly standup begins	 (listValue (filter (getProperty (singleton en.meeting) (string !type)) (ensureNumericProperty (string end_time)) (string <=) (ensureNumericEntity (getProperty en.meeting.weekly_standup (string start_time)))))
show me all meetings that have two attendees	 (listValue (countComparative (getProperty (singleton en.meeting) (string !type)) (string attendee) (string =) (number 2)))
show me all attendees of meetings on january 2nd	 (listValue (filter (getProperty (singleton en.person) (string !type)) (reverse (string attendee)) (string =) (filter (getProperty (singleton en.meeting) (string !type)) (string date) (string =) (date 2015 1 2))))
meeting which starts at 10 am	 (listValue (filter (getProperty (singleton en.meeting) (string !type)) (string start_time) (string =) (time 10 0)))
what important meeting has a location at greenberg cafe	 (listValue (filter (filter (getProperty (singleton en.meeting) (string !type)) (string is_important)) (string location) (string =) en.location.greenberg_cafe))
show me all three hour meetings on jan 2	 (listValue (filter (filter (getProperty (singleton en.meeting) (string !type)) (string length) (string =) (number 3 en.hour)) (string date) (string =) (date 2015 1 2)))
find all meetings which begin on january 2nd or january 3rd	 (listValue (concat (date 2015 1 2) (date 2015 1 3)))
which meeting begins earliest	 (listValue (superlative (getProperty (singleton en.meeting) (string !type)) (string min) (ensureNumericProperty (string start_time))))
show me all meetings ending after 10 am or 3 pm	 (listValue (filter (getProperty (singleton en.meeting) (string !type)) (ensureNumericProperty (string end_time)) (string >) (ensureNumericEntity (concat (time 10 0) (time 15 0)))))
what meeting ends at most at 10am	 (listValue (filter (getProperty (singleton en.meeting) (string !type)) (ensureNumericProperty (string end_time)) (string <=) (ensureNumericEntity (time 10 0))))
location features the largest number of meetings	 (listValue (countSuperlative (getProperty (singleton en.location) (string !type)) (string max) (reverse (string location)) (getProperty (singleton en.meeting) (string !type))))
what meetings have a start time of 10 am or 3pm	 (listValue (filter (getProperty (singleton en.meeting) (string !type)) (string start_time) (string =) (concat (time 10 0) (time 15 0))))
meetings at greenberg cafe attended by alice	 (listValue (filter (filter (getProperty (singleton en.meeting) (string !type)) (string attendee) (string =) en.person.alice) (string location) (string =) en.location.greenberg_cafe))
show me the dates of all weekly standup meetings	 (listValue (getProperty en.meeting.weekly_standup (string date)))
what meeting has an end time the same as weekly standup	 (listValue (filter (getProperty (singleton en.meeting) (string !type)) (ensureNumericProperty (string end_time)) (string <=) (ensureNumericEntity (getProperty en.meeting.weekly_standup (string start_time)))))
what meetings end at the same time as the weekly roundup meeting	 (listValue (filter (getProperty (singleton en.meeting) (string !type)) (string end_time) (string =) (getProperty en.meeting.weekly_standup (string end_time))))
meeting in which alice is attending which starts at 1000 am	 (listValue (filter (filter (getProperty (singleton en.meeting) (string !type)) (string attendee) (string =) en.person.alice) (string start_time) (string =) (time 10 0)))
show me all meetings scheduled to be less than three hours or less than one hour	 (listValue (filter (getProperty (singleton en.meeting) (string !type)) (ensureNumericProperty (string length)) (string <) (ensureNumericEntity (concat (number 3 en.hour) (number 1 en.hour)))))
which meeting is scheduled on the earliest date	 (listValue (superlative (getProperty (singleton en.meeting) (string !type)) (string min) (ensureNumericProperty (string date))))
meetings held later than january 2	 (listValue (filter (getProperty (singleton en.meeting) (string !type)) (ensureNumericProperty (string date)) (string >) (ensureNumericEntity (date 2015 1 2))))
show me meetings that take 3 hours and are with alice	 (listValue (filter (filter (getProperty (singleton en.meeting) (string !type)) (string length) (string =) (number 3 en.hour)) (string attendee) (string =) en.person.alice))
what person is attending weekly startup	 (listValue (filter (getProperty (singleton en.person) (string !type)) (reverse (string attendee)) (string =) en.meeting.weekly_standup))
meeting starts before 10am or 3pm	 (listValue (filter (getProperty (singleton en.meeting) (string !type)) (ensureNumericProperty (string start_time)) (string <) (ensureNumericEntity (concat (time 10 0) (time 15 0)))))
what meeting no later than that of weekly startup	 (listValue (filter (getProperty (singleton en.meeting) (string !type)) (ensureNumericProperty (string date)) (string <=) (ensureNumericEntity (getProperty en.meeting.weekly_standup (string date)))))
what meeting is longer than weekly standup	 (listValue (filter (getProperty (singleton en.meeting) (string !type)) (ensureNumericProperty (string length)) (string >) (ensureNumericEntity (getProperty en.meeting.weekly_standup (string length)))))
what meeting has a after jan 2 or 3	 (listValue (filter (getProperty (singleton en.meeting) (string !type)) (ensureNumericProperty (string date)) (string >) (ensureNumericEntity (concat (date 2015 1 2) (date 2015 1 3)))))
show me all meetings which begin after the weekly standup ends	 (listValue (filter (getProperty (singleton en.meeting) (string !type)) (ensureNumericProperty (string start_time)) (string >=) (ensureNumericEntity (getProperty en.meeting.weekly_standup (string end_time)))))
what is the start time for the weekly stand up meeting	 (listValue (getProperty en.meeting.weekly_standup (string start_time)))
how long is the meeting	 (listValue (aggregate (string sum) (getProperty (getProperty (singleton en.meeting) (string !type)) (string length))))
meetings that end after the weekly startup meeting starts	 (listValue (filter (getProperty (singleton en.meeting) (string !type)) (ensureNumericProperty (string end_time)) (string >) (ensureNumericEntity (getProperty en.meeting.weekly_standup (string start_time)))))
meetings that are attended by alice and are three hours long	 (listValue (filter (filter (getProperty (singleton en.meeting) (string !type)) (string length) (string =) (number 3 en.hour)) (string attendee) (string =) en.person.alice))
who is at the weekly standup or annual review	 (listValue (filter (getProperty (singleton en.person) (string !type)) (reverse (string attendee)) (string =) (concat en.meeting.weekly_standup en.meeting.annual_review)))
which meetings end at 10am	 (listValue (filter (filter (getProperty (singleton en.meeting) (string !type)) (string end_time) (string =) (time 10 0)) (string end_time) (string =) (time 10 0)))
meetings that end at 10am and start at 10am	 (listValue (filter (filter (getProperty (singleton en.meeting) (string !type)) (string end_time) (string =) (time 10 0)) (string start_time) (string =) (time 10 0)))
meeting which is on jan 2 or jan 3	 (listValue (filter (getProperty (singleton en.meeting) (string !type)) (string date) (string =) (concat (date 2015 1 2) (date 2015 1 3))))
show me the people attending the most meetings	 (listValue (countSuperlative (getProperty (singleton en.person) (string !type)) (string min) (reverse (string attendee)) (getProperty (singleton en.meeting) (string !type))))
important meeting at 10am	 (listValue (filter (filter (getProperty (singleton en.meeting) (string !type)) (string is_important)) (string start_time) (string =) (time 10 0)))
what meeting starts the earliest	 (listValue (superlative (getProperty (singleton en.meeting) (string !type)) (string min) (ensureNumericProperty (string start_time))))
locations that do not house the weekly standup meeting	 (listValue (filter (getProperty (singleton en.location) (string !type)) (reverse (string location)) (string !=) en.meeting.weekly_standup))
show me important meetings that start at 10am	 (listValue (filter (filter (getProperty (singleton en.meeting) (string !type)) (string is_important)) (string start_time) (string =) (time 10 0)))
what is the length of weekly startup	 (listValue (getProperty en.meeting.weekly_standup (string length)))
show me all meeting that take place by jan 3	 (listValue (filter (getProperty (singleton en.meeting) (string !type)) (ensureNumericProperty (string date)) (string <=) (ensureNumericEntity (concat (date 2015 1 2) (date 2015 1 3)))))
where is the weekly standup	 (listValue (filter (filter (getProperty (singleton en.location) (string !type)) (reverse (string location)) (string =) en.meeting.weekly_standup) (reverse (string location)) (string =) en.meeting.weekly_standup))
show me all meetings lasting three hours beginning at 10 am	 (listValue (filter (filter (getProperty (singleton en.meeting) (string !type)) (string length) (string =) (number 3 en.hour)) (string start_time) (string =) (time 10 0)))
meetings that end at 10am	 (listValue (filter (getProperty (singleton en.meeting) (string !type)) (string end_time) (string =) (time 10 0)))
show me the dates of the weekly standup meetings	 (listValue (getProperty en.meeting.weekly_standup (string date)))
meeting which ends at or after the end time of weekly standup	 (listValue (filter (getProperty (singleton en.meeting) (string !type)) (ensureNumericProperty (string end_time)) (string >=) (ensureNumericEntity (getProperty en.meeting.weekly_standup (string end_time)))))
meetings that are not held at greenberg cafe	 (listValue (filter (getProperty (singleton en.meeting) (string !type)) (string location) (string !=) en.location.greenberg_cafe))
what meeting has an end time no greater than the end of weekly startup	 (listValue (filter (getProperty (singleton en.meeting) (string !type)) (ensureNumericProperty (string end_time)) (string >) (ensureNumericEntity (getProperty en.meeting.weekly_standup (string end_time)))))
meetings that start at 10am	 (listValue (filter (filter (getProperty (singleton en.meeting) (string !type)) (string start_time) (string =) (time 10 0)) (string start_time) (string =) (time 10 0)))
meetings that end before the weekly standup meeting starts	 (listValue (filter (getProperty (singleton en.meeting) (string !type)) (ensureNumericProperty (string end_time)) (string <) (ensureNumericEntity (getProperty en.meeting.weekly_standup (string start_time)))))
meetings that end at the same as the weekly standup meeting	 (listValue (filter (getProperty (singleton en.meeting) (string !type)) (string end_time) (string =) (getProperty en.meeting.weekly_standup (string end_time))))
show me all meetings labeled as important that start at 10 am	 (listValue (filter (filter (getProperty (singleton en.meeting) (string !type)) (string start_time) (string =) (time 10 0)) (string is_important)))
show me all meetings ending later than the weekly standup	 (listValue (filter (getProperty (singleton en.meeting) (string !type)) (ensureNumericProperty (string end_time)) (string >) (ensureNumericEntity (getProperty en.meeting.weekly_standup (string end_time)))))
meeting that ends sooner than weekly standup ends	 (listValue (filter (getProperty (singleton en.meeting) (string !type)) (ensureNumericProperty (string end_time)) (string <) (ensureNumericEntity (getProperty en.meeting.weekly_standup (string end_time)))))
show me all meetings happening before january 2nd or january 3rd	 (listValue (filter (getProperty (singleton en.meeting) (string !type)) (ensureNumericProperty (string date)) (string <) (ensureNumericEntity (concat (date 2015 1 2) (date 2015 1 3)))))
is the meeting at 10am or 3pm	 (listValue (concat (time 10 0) (time 15 0)))
meeting which has minimum two attendees	 (listValue (countComparative (getProperty (singleton en.meeting) (string !type)) (string attendee) (string >=) (number 2)))
show me the locations of all meetings beginning at 10 am	 (listValue (filter (getProperty (singleton en.location) (string !type)) (reverse (string location)) (string =) (filter (getProperty (singleton en.meeting) (string !type)) (string start_time) (string =) (time 10 0))))
person who attends weekly standup	 (listValue (filter (getProperty (singleton en.person) (string !type)) (reverse (string attendee)) (string =) en.meeting.weekly_standup))
meeting longer than one or three hours	 (listValue (filter (getProperty (singleton en.meeting) (string !type)) (ensureNumericProperty (string length)) (string >) (ensureNumericEntity (concat (number 3 en.hour) (number 1 en.hour)))))
show me meetings at fewer than two locations	 (listValue (countComparative (getProperty (singleton en.meeting) (string !type)) (string location) (string <) (number 2)))
select all important meetings	 (listValue (filter (filter (getProperty (singleton en.meeting) (string !type)) (string is_important)) (string is_important)))
what meeting starts before 10am or 3pm	 (listValue (filter (getProperty (singleton en.meeting) (string !type)) (ensureNumericProperty (string start_time)) (string <) (ensureNumericEntity (concat (time 10 0) (time 15 0)))))
show me all meetings that begin at the time the weekly standup meeting ends	 (listValue (filter (getProperty (singleton en.meeting) (string !type)) (string start_time) (string =) (getProperty en.meeting.weekly_standup (string end_time))))
what meeting has the same location as weekly standup	 (listValue (filter (getProperty (singleton en.meeting) (string !type)) (string location) (string =) (filter (getProperty (singleton en.location) (string !type)) (reverse (string location)) (string =) en.meeting.weekly_standup)))
what meetings have the same start time as the week startup meeting	 (listValue (filter (getProperty (singleton en.meeting) (string !type)) (string start_time) (string =) (getProperty en.meeting.weekly_standup (string start_time))))
meetings held before january 3	 (listValue (filter (getProperty (singleton en.meeting) (string !type)) (ensureNumericProperty (string date)) (string <=) (ensureNumericEntity (concat (date 2015 1 2) (date 2015 1 3)))))
show me all attendees of meetings beginning at 10 am	 (listValue (filter (getProperty (singleton en.person) (string !type)) (reverse (string attendee)) (string =) (filter (getProperty (singleton en.meeting) (string !type)) (string start_time) (string =) (time 10 0))))
meetings on january 2 that end at 10am	 (listValue (filter (filter (getProperty (singleton en.meeting) (string !type)) (string date) (string =) (date 2015 1 2)) (string end_time) (string =) (time 10 0)))
show me all meetings which begin at the same time or earlier than the weekly standup ends	 (listValue (filter (getProperty (singleton en.meeting) (string !type)) (ensureNumericProperty (string start_time)) (string <=) (ensureNumericEntity (getProperty en.meeting.weekly_standup (string end_time)))))
what meeting starts at 10am	 (listValue (filter (filter (getProperty (singleton en.meeting) (string !type)) (string start_time) (string =) (time 10 0)) (string start_time) (string =) (time 10 0)))
what meeting starts at least at 10am	 (listValue (filter (getProperty (singleton en.meeting) (string !type)) (ensureNumericProperty (string start_time)) (string >=) (ensureNumericEntity (time 10 0))))
how long is the weekly standup meeting	 (listValue (getProperty en.meeting.weekly_standup (string length)))
what is the meeting that take place immediately before the weekly standup	 (listValue (filter (getProperty (singleton en.meeting) (string !type)) (ensureNumericProperty (string end_time)) (string <=) (ensureNumericEntity (getProperty en.meeting.weekly_standup (string start_time)))))
what is the location that more than two meetings will be held at	 (listValue (countComparative (getProperty (singleton en.location) (string !type)) (reverse (string location)) (string >) (number 2) (getProperty (singleton en.meeting) (string !type))))
show me the locations of all meetings on january 2	 (listValue (filter (getProperty (singleton en.location) (string !type)) (reverse (string location)) (string =) (filter (getProperty (singleton en.meeting) (string !type)) (string date) (string =) (date 2015 1 2))))
show me all attendees of meetings three hours long	 (listValue (filter (getProperty (singleton en.person) (string !type)) (reverse (string attendee)) (string =) (filter (getProperty (singleton en.meeting) (string !type)) (string length) (string =) (number 3 en.hour))))
show me meetings which do not conclude at 10am	 (listValue (filter (getProperty (singleton en.meeting) (string !type)) (string end_time) (string !=) (time 10 0)))
meetings attended by people that attend the weekly standup meeting	 (listValue (filter (getProperty (singleton en.meeting) (string !type)) (string attendee) (string =) (getProperty en.meeting.weekly_standup (string attendee))))
what meetings take place on jan 2 in greenberg cafe	 (listValue (filter (filter (getProperty (singleton en.meeting) (string !type)) (string location) (string =) en.location.greenberg_cafe) (string date) (string =) (date 2015 1 2)))
what meeting is the same length as that of weekly startup	 (listValue (filter (getProperty (singleton en.meeting) (string !type)) (string length) (string =) (getProperty en.meeting.weekly_standup (string length))))
what person is not attending the weekly standup meeting	 (listValue (filter (getProperty (singleton en.person) (string !type)) (reverse (string attendee)) (string !=) en.meeting.weekly_standup))
meetings at greenberg cafe that start at 10am	 (listValue (filter (filter (getProperty (singleton en.meeting) (string !type)) (string location) (string =) en.location.greenberg_cafe) (string start_time) (string =) (time 10 0)))
meetings held on the same day as or after the weekly standup meeting	 (listValue (filter (getProperty (singleton en.meeting) (string !type)) (ensureNumericProperty (string date)) (string >=) (ensureNumericEntity (getProperty en.meeting.weekly_standup (string date)))))
show me all meetings happening on the same day or before the weekly standup	 (listValue (filter (getProperty (singleton en.meeting) (string !type)) (ensureNumericProperty (string date)) (string <=) (ensureNumericEntity (getProperty en.meeting.weekly_standup (string date)))))
show me all meetings attended by either alice or bob	 (listValue (filter (getProperty (singleton en.meeting) (string !type)) (string attendee) (string =) (concat en.person.alice en.person.bob)))
what meeting starts at least at 10am or 3pm	 (listValue (filter (getProperty (singleton en.meeting) (string !type)) (ensureNumericProperty (string start_time)) (string >=) (ensureNumericEntity (concat (time 10 0) (time 15 0)))))
find me a meeting shorter than three hours	 (listValue (filter (getProperty (singleton en.meeting) (string !type)) (ensureNumericProperty (string length)) (string <) (ensureNumericEntity (number 3 en.hour))))
what location is most meetings	 (listValue (countSuperlative (getProperty (singleton en.location) (string !type)) (string max) (reverse (string location)) (getProperty (singleton en.meeting) (string !type))))
weekly startup attendee	 (listValue (getProperty en.meeting.weekly_standup (string attendee)))
show me all meeting that begin at 10am	 (listValue (filter (filter (getProperty (singleton en.meeting) (string !type)) (string start_time) (string =) (time 10 0)) (string start_time) (string =) (time 10 0)))
show me meetings that end before the weekly standup starts	 (listValue (filter (getProperty (singleton en.meeting) (string !type)) (ensureNumericProperty (string end_time)) (string >=) (ensureNumericEntity (getProperty en.meeting.weekly_standup (string start_time)))))
meeting shares attendee with weekly standup	 (listValue (filter (getProperty (singleton en.meeting) (string !type)) (string attendee) (string =) (filter (getProperty (singleton en.person) (string !type)) (reverse (string attendee)) (string =) en.meeting.weekly_standup)))
show me meetings at 10am with alice	 (listValue (filter (filter (getProperty (singleton en.meeting) (string !type)) (string start_time) (string =) (time 10 0)) (string attendee) (string =) en.person.alice))
meetings that do not end at 10am	 (listValue (filter (getProperty (singleton en.meeting) (string !type)) (string end_time) (string !=) (time 10 0)))
what meeting ends at 10am on january second	 (listValue (filter (filter (getProperty (singleton en.meeting) (string !type)) (string end_time) (string =) (time 10 0)) (string date) (string =) (date 2015 1 2)))
people that do not attend the weekly standup meeting	 (listValue (filter (getProperty (singleton en.person) (string !type)) (reverse (string attendee)) (string !=) en.meeting.weekly_standup))
meetings that are three hours or longer or an hour or longer	 (listValue (filter (getProperty (singleton en.meeting) (string !type)) (ensureNumericProperty (string length)) (string >=) (ensureNumericEntity (concat (number 3 en.hour) (number 1 en.hour)))))
meeting on january 2nd at 10am	 (listValue (filter (filter (getProperty (singleton en.meeting) (string !type)) (string start_time) (string =) (time 10 0)) (string date) (string =) (date 2015 1 2)))
show me meetings before jan 3	 (listValue (filter (getProperty (singleton en.meeting) (string !type)) (ensureNumericProperty (string date)) (string <) (ensureNumericEntity (concat (date 2015 1 2) (date 2015 1 3)))))
show me the meetings with the least number of different locations	 (listValue (countSuperlative (getProperty (singleton en.meeting) (string !type)) (string min) (string location)))
show me locations of all meetings which are marked as important	 (listValue (filter (getProperty (singleton en.location) (string !type)) (reverse (string location)) (string =) (filter (getProperty (singleton en.meeting) (string !type)) (string is_important))))
show me all meetings attended by people who have also attended the weekly standup meeting	 (listValue (filter (getProperty (singleton en.meeting) (string !type)) (string attendee) (string =) (getProperty en.meeting.weekly_standup (string attendee))))
people attending meetings that end at 10am	 (listValue (filter (getProperty (singleton en.person) (string !type)) (reverse (string attendee)) (string =) (filter (getProperty (singleton en.meeting) (string !type)) (string end_time) (string =) (time 10 0))))
show me who is attending three hour meetings	 (listValue (filter (getProperty (singleton en.person) (string !type)) (reverse (string attendee)) (string =) (filter (getProperty (singleton en.meeting) (string !type)) (string length) (string =) (number 3 en.hour))))
what meeting has the least number of attendees	 (listValue (countSuperlative (getProperty (singleton en.meeting) (string !type)) (string min) (string attendee)))
show me all meetings marked important	 (listValue (filter (filter (getProperty (singleton en.meeting) (string !type)) (string is_important)) (string is_important)))
meetings attended by two or fewer people	 (listValue (countComparative (getProperty (singleton en.meeting) (string !type)) (string attendee) (string <=) (number 2)))
what meeting had someone who went to weekly standup	 (listValue (filter (getProperty (singleton en.meeting) (string !type)) (string attendee) (string =) (getProperty en.meeting.weekly_standup (string attendee))))
show me who is not at the weekly standup	 (listValue (filter (getProperty (singleton en.person) (string !type)) (reverse (string attendee)) (string !=) en.meeting.weekly_standup))
show me all meetings beginning and ending at 10 am	 (listValue (filter (filter (getProperty (singleton en.meeting) (string !type)) (string start_time) (string =) (time 10 0)) (string end_time) (string =) (time 10 0)))
important meetings attended by alice	 (listValue (filter (filter (getProperty (singleton en.meeting) (string !type)) (string is_important)) (string attendee) (string =) en.person.alice))
meetings that start earlier than the weekly standup meeting	 (listValue (filter (getProperty (singleton en.meeting) (string !type)) (ensureNumericProperty (string start_time)) (string <) (ensureNumericEntity (getProperty en.meeting.weekly_standup (string start_time)))))
what meeting is being held at the greenberg cafe	 (listValue (filter (getProperty (singleton en.meeting) (string !type)) (string location) (string =) en.location.greenberg_cafe))
what three hour meeting has alice attending	 (listValue (filter (filter (getProperty (singleton en.meeting) (string !type)) (string attendee) (string =) en.person.alice) (string length) (string =) (number 3 en.hour)))
show me the longest meetings	 (listValue (superlative (getProperty (singleton en.meeting) (string !type)) (string max) (ensureNumericProperty (string length))))
show me all locations which do not host the weekly standup	 (listValue (filter (getProperty (singleton en.location) (string !type)) (reverse (string location)) (string !=) en.meeting.weekly_standup))
what is an important meeting	 (listValue (filter (filter (getProperty (singleton en.meeting) (string !type)) (string is_important)) (string is_important)))
show me all meetings which begin at 10 am and end at 10 am	 (listValue (filter (filter (getProperty (singleton en.meeting) (string !type)) (string end_time) (string =) (time 10 0)) (string start_time) (string =) (time 10 0)))
show me all meetings scheduled to be three hours or one hour long	 (listValue (concat (number 3 en.hour) (number 1 en.hour)))
three hour meeting at greenberg cafe	 (listValue (filter (filter (getProperty (singleton en.meeting) (string !type)) (string length) (string =) (number 3 en.hour)) (string location) (string =) en.location.greenberg_cafe))
people attending meetings that alice attends	 (listValue (filter (getProperty (singleton en.person) (string !type)) (reverse (string attendee)) (string =) (filter (getProperty (singleton en.meeting) (string !type)) (string attendee) (string =) en.person.alice)))
show me the attendees for all meetings on jan 2	 (listValue (filter (getProperty (singleton en.person) (string !type)) (reverse (string attendee)) (string =) (filter (getProperty (singleton en.meeting) (string !type)) (string date) (string =) (date 2015 1 2))))
show me everyone who attended meetings also attended by alice	 (listValue (filter (getProperty (singleton en.person) (string !type)) (reverse (string attendee)) (string =) (filter (getProperty (singleton en.meeting) (string !type)) (string attendee) (string =) en.person.alice)))
who is the person attending the weekly stand up meeting	 (listValue (filter (filter (getProperty (singleton en.person) (string !type)) (reverse (string attendee)) (string =) en.meeting.weekly_standup) (reverse (string attendee)) (string =) en.meeting.weekly_standup))
what meeting has a length greater than weekly startup	 (listValue (filter (getProperty (singleton en.meeting) (string !type)) (ensureNumericProperty (string length)) (string >) (ensureNumericEntity (getProperty en.meeting.weekly_standup (string length)))))
what person is an attendee of more than two meetings	 (listValue (countComparative (getProperty (singleton en.person) (string !type)) (reverse (string attendee)) (string >) (number 2) (getProperty (singleton en.meeting) (string !type))))
meeting before jan 2	 (listValue (filter (getProperty (singleton en.meeting) (string !type)) (ensureNumericProperty (string date)) (string <) (ensureNumericEntity (date 2015 1 2))))
show me any meetings alice has attended on january 2nd	 (listValue (filter (filter (getProperty (singleton en.meeting) (string !type)) (string date) (string =) (date 2015 1 2)) (string attendee) (string =) en.person.alice))
what meeting has an end time earlier than weekly startup	 (listValue (filter (getProperty (singleton en.meeting) (string !type)) (ensureNumericProperty (string end_time)) (string <) (ensureNumericEntity (getProperty en.meeting.weekly_standup (string start_time)))))
show me meetings that will end before weekly standup begins	 (listValue (filter (getProperty (singleton en.meeting) (string !type)) (ensureNumericProperty (string end_time)) (string <) (ensureNumericEntity (getProperty en.meeting.weekly_standup (string start_time)))))
what meetings on january 2 end at 10am	 (listValue (filter (filter (getProperty (singleton en.meeting) (string !type)) (string end_time) (string =) (time 10 0)) (string date) (string =) (date 2015 1 2)))
what important meetings are attended by alice	 (listValue (filter (filter (getProperty (singleton en.meeting) (string !type)) (string attendee) (string =) en.person.alice) (string is_important)))
meetings that are the same length as the weekly standup meeting	 (listValue (filter (getProperty (singleton en.meeting) (string !type)) (string length) (string =) (getProperty en.meeting.weekly_standup (string length))))
meeting ends after 10am	 (listValue (filter (getProperty (singleton en.meeting) (string !type)) (ensureNumericProperty (string end_time)) (string >) (ensureNumericEntity (time 10 0))))
meetings that start after the weekly standup meeting starts	 (listValue (filter (getProperty (singleton en.meeting) (string !type)) (ensureNumericProperty (string start_time)) (string >) (ensureNumericEntity (getProperty en.meeting.weekly_standup (string start_time)))))
what meeting has the shortest time	 (listValue (superlative (getProperty (singleton en.meeting) (string !type)) (string min) (ensureNumericProperty (string end_time))))
meeting that starts later than start of weekly standup	 (listValue (filter (getProperty (singleton en.meeting) (string !type)) (ensureNumericProperty (string end_time)) (string >) (ensureNumericEntity (getProperty en.meeting.weekly_standup (string start_time)))))
show me all meetings that have at most two locations	 (listValue (countComparative (getProperty (singleton en.meeting) (string !type)) (string location) (string <=) (number 2)))
what important meetings start at 10am	 (listValue (filter (filter (getProperty (singleton en.meeting) (string !type)) (string start_time) (string =) (time 10 0)) (string is_important)))
january 2nd meeting	 (listValue (filter (filter (getProperty (singleton en.meeting) (string !type)) (string date) (string =) (date 2015 1 2)) (string date) (string =) (date 2015 1 2)))
what meeting has an end time of at least 10am	 (listValue (filter (getProperty (singleton en.meeting) (string !type)) (ensureNumericProperty (string end_time)) (string >=) (ensureNumericEntity (time 10 0))))
what meeting was shorter than three hours	 (listValue (filter (getProperty (singleton en.meeting) (string !type)) (ensureNumericProperty (string length)) (string <) (ensureNumericEntity (concat (number 3 en.hour) (number 1 en.hour)))))
what important meeting is located at greenberg cafe	 (listValue (filter (filter (getProperty (singleton en.meeting) (string !type)) (string location) (string =) en.location.greenberg_cafe) (string is_important)))
what meeting has an end time smaller than weekly standup	 (listValue (filter (getProperty (singleton en.meeting) (string !type)) (ensureNumericProperty (string end_time)) (string <) (ensureNumericEntity (getProperty en.meeting.weekly_standup (string end_time)))))
show me all people who have attended more than two meetings	 (listValue (countComparative (getProperty (singleton en.person) (string !type)) (reverse (string attendee)) (string >) (number 2) (getProperty (singleton en.meeting) (string !type))))
meetings on or before january 2	 (listValue (filter (getProperty (singleton en.meeting) (string !type)) (ensureNumericProperty (string date)) (string <=) (ensureNumericEntity (date 2015 1 2))))
what location has more than two meetings	 (listValue (countComparative (getProperty (singleton en.location) (string !type)) (reverse (string location)) (string >) (number 2) (getProperty (singleton en.meeting) (string !type))))
meetings held in the most locations	 (listValue (countSuperlative (getProperty (singleton en.meeting) (string !type)) (string max) (string location)))
meetings at greenberg cafe that end a 10am	 (listValue (filter (filter (getProperty (singleton en.meeting) (string !type)) (string end_time) (string =) (time 10 0)) (string location) (string =) en.location.greenberg_cafe))
three hour meeting with alice as attendee	 (listValue (filter (filter (getProperty (singleton en.meeting) (string !type)) (string attendee) (string =) en.person.alice) (string length) (string =) (number 3 en.hour)))
what meeting starts at the weekly standup average start time	 (listValue (filter (getProperty (singleton en.meeting) (string !type)) (ensureNumericProperty (string start_time)) (string <=) (ensureNumericEntity (getProperty en.meeting.weekly_standup (string start_time)))))
show meetings that start no earlier than the weekly startup meeting	 (listValue (filter (getProperty (singleton en.meeting) (string !type)) (ensureNumericProperty (string start_time)) (string >=) (ensureNumericEntity (getProperty en.meeting.weekly_standup (string start_time)))))
show me all meetings alice is attending which are three hours long	 (listValue (filter (filter (getProperty (singleton en.meeting) (string !type)) (string length) (string =) (number 3 en.hour)) (string attendee) (string =) en.person.alice))
show me all meetings which end at the same time the weekly standup begins	 (listValue (filter (getProperty (singleton en.meeting) (string !type)) (string end_time) (string =) (getProperty en.meeting.weekly_standup (string start_time))))
what meeting has a start time at the end time of weekly standup	 (listValue (filter (getProperty (singleton en.meeting) (string !type)) (string start_time) (string =) (getProperty en.meeting.weekly_standup (string end_time))))
locations of important meetings	 (listValue (filter (getProperty (singleton en.location) (string !type)) (reverse (string location)) (string =) (filter (getProperty (singleton en.meeting) (string !type)) (string is_important))))
show me meetings starting at 10am or 3pm	 (listValue (filter (getProperty (singleton en.meeting) (string !type)) (ensureNumericProperty (string start_time)) (string >=) (ensureNumericEntity (concat (time 10 0) (time 15 0)))))
what meeting starts before weekly standup ends	 (listValue (filter (getProperty (singleton en.meeting) (string !type)) (ensureNumericProperty (string start_time)) (string <) (ensureNumericEntity (getProperty en.meeting.weekly_standup (string end_time)))))
show me all meetings three hours long	 (listValue (filter (getProperty (singleton en.meeting) (string !type)) (string length) (string =) (number 3 en.hour)))
locations that house at least two meetings	 (listValue (countComparative (getProperty (singleton en.location) (string !type)) (reverse (string location)) (string >=) (number 2) (getProperty (singleton en.meeting) (string !type))))
show me meetings not on jan 2	 (listValue (filter (getProperty (singleton en.meeting) (string !type)) (string date) (string !=) (date 2015 1 2)))
meeting ends after end time of weekly standup	 (listValue (filter (getProperty (singleton en.meeting) (string !type)) (ensureNumericProperty (string end_time)) (string >) (ensureNumericEntity (getProperty en.meeting.weekly_standup (string end_time)))))
show me the location of all meetings attended by alice	 (listValue (filter (getProperty (singleton en.location) (string !type)) (reverse (string location)) (string =) (filter (getProperty (singleton en.meeting) (string !type)) (string attendee) (string =) en.person.alice)))
show me all meetings on january 2nd which end at 10 am	 (listValue (filter (filter (getProperty (singleton en.meeting) (string !type)) (string end_time) (string =) (time 10 0)) (string date) (string =) (date 2015 1 2)))
show me all meetings at the greenberg cafe ending at 10 am	 (listValue (filter (filter (getProperty (singleton en.meeting) (string !type)) (string end_time) (string =) (time 10 0)) (string location) (string =) en.location.greenberg_cafe))
three hours long important meeting	 (listValue (filter (filter (getProperty (singleton en.meeting) (string !type)) (string length) (string =) (number 3 en.hour)) (string is_important)))
what meeting has alice attending and starts at 10am	 (listValue (filter (filter (getProperty (singleton en.meeting) (string !type)) (string attendee) (string =) en.person.alice) (string start_time) (string =) (time 10 0)))
important meetings that start at 10am	 (listValue (filter (filter (getProperty (singleton en.meeting) (string !type)) (string is_important)) (string start_time) (string =) (time 10 0)))
how many meetings are there	 (listValue (call .size (getProperty (singleton en.meeting) (string !type))))
weekly standup end time	 (listValue (getProperty en.meeting.weekly_standup (string end_time)))
what location is the meeting who has alice attending	 (listValue (filter (getProperty (singleton en.location) (string !type)) (reverse (string location)) (string =) (filter (getProperty (singleton en.meeting) (string !type)) (string attendee) (string =) en.person.alice)))
show me any meetings that alice has not attended	 (listValue (filter (getProperty (singleton en.meeting) (string !type)) (string attendee) (string !=) en.person.alice))
how long does the average meeting last	 (listValue (aggregate (string avg) (getProperty (getProperty (singleton en.meeting) (string !type)) (string length))))
show me all meetings on jan 2	 (listValue (filter (filter (getProperty (singleton en.meeting) (string !type)) (string date) (string =) (date 2015 1 2)) (string date) (string =) (date 2015 1 2)))
person is attendee of weekly standup or annual review	 (listValue (filter (getProperty (singleton en.person) (string !type)) (reverse (string attendee)) (string =) (concat en.meeting.weekly_standup en.meeting.annual_review)))
meetings that are three hours or longer	 (listValue (filter (getProperty (singleton en.meeting) (string !type)) (ensureNumericProperty (string length)) (string >=) (ensureNumericEntity (number 3 en.hour))))
important meetings that end at 10am	 (listValue (filter (filter (getProperty (singleton en.meeting) (string !type)) (string end_time) (string =) (time 10 0)) (string is_important)))
show me all meetings on january 2nd ending at 10 am	 (listValue (filter (filter (getProperty (singleton en.meeting) (string !type)) (string date) (string =) (date 2015 1 2)) (string end_time) (string =) (time 10 0)))
meetings that are shorter than three hours or shorter than one hour	 (listValue (filter (getProperty (singleton en.meeting) (string !type)) (ensureNumericProperty (string length)) (string <) (ensureNumericEntity (concat (number 3 en.hour) (number 1 en.hour)))))
meetings that end at 10am or 3pm	 (listValue (filter (getProperty (singleton en.meeting) (string !type)) (string end_time) (string =) (concat (time 10 0) (time 15 0))))
meeting does not start at 10am	 (listValue (filter (getProperty (singleton en.meeting) (string !type)) (string start_time) (string !=) (time 10 0)))
meetings starting later than 10am	 (listValue (filter (getProperty (singleton en.meeting) (string !type)) (ensureNumericProperty (string start_time)) (string <) (ensureNumericEntity (time 10 0))))
show me all meetings at least three hours long	 (listValue (filter (getProperty (singleton en.meeting) (string !type)) (ensureNumericProperty (string length)) (string >=) (ensureNumericEntity (number 3 en.hour))))
show me meetings happening after jan 2nd	 (listValue (filter (getProperty (singleton en.meeting) (string !type)) (ensureNumericProperty (string date)) (string >) (ensureNumericEntity (date 2015 1 2))))
what meeting has the smallest length	 (listValue (superlative (getProperty (singleton en.meeting) (string !type)) (string min) (ensureNumericProperty (string length))))
show me all meetings ending at 10am that alice is attending	 (listValue (filter (filter (getProperty (singleton en.meeting) (string !type)) (string attendee) (string =) en.person.alice) (string end_time) (string =) (time 10 0)))
important meeting at greenberg cafe	 (listValue (filter (filter (getProperty (singleton en.meeting) (string !type)) (string is_important)) (string location) (string =) en.location.greenberg_cafe))
show me all metings in greenberg cafe that end at 10am	 (listValue (filter (filter (getProperty (singleton en.meeting) (string !type)) (string end_time) (string =) (time 10 0)) (string location) (string =) en.location.greenberg_cafe))
meetings that are shorter than three hours	 (listValue (filter (getProperty (singleton en.meeting) (string !type)) (ensureNumericProperty (string length)) (string <) (ensureNumericEntity (number 3 en.hour))))
show me all meetings marked as important	 (listValue (filter (getProperty (singleton en.meeting) (string !type)) (string is_important)))
show me all meetings on january 2nd beginning at 10 am	 (listValue (filter (filter (getProperty (singleton en.meeting) (string !type)) (string date) (string =) (date 2015 1 2)) (string start_time) (string =) (time 10 0)))
show me all meetings which has no more than two attendees	 (listValue (countComparative (getProperty (singleton en.meeting) (string !type)) (string attendee) (string <=) (number 2)))
who will be attending important meetings	 (listValue (filter (getProperty (singleton en.person) (string !type)) (reverse (string attendee)) (string =) (filter (getProperty (singleton en.meeting) (string !type)) (string is_important))))
meetings that end at the same time as or before the weekly standup meeting ends	 (listValue (filter (getProperty (singleton en.meeting) (string !type)) (ensureNumericProperty (string end_time)) (string <=) (ensureNumericEntity (getProperty en.meeting.weekly_standup (string end_time)))))
show me all attendees of meetings marked important	 (listValue (filter (getProperty (singleton en.person) (string !type)) (reverse (string attendee)) (string =) (filter (getProperty (singleton en.meeting) (string !type)) (string is_important))))
show me all meetings no longer than the weekly standup	 (listValue (filter (getProperty (singleton en.meeting) (string !type)) (ensureNumericProperty (string length)) (string <=) (ensureNumericEntity (getProperty en.meeting.weekly_standup (string length)))))
what meeting starts when weekly standup ends	 (listValue (filter (getProperty (singleton en.meeting) (string !type)) (string start_time) (string =) (getProperty en.meeting.weekly_standup (string end_time))))
show me all meetings between 10am and 3pm	 (listValue (concat (time 10 0) (time 15 0)))
show me the meeting alice will attend which ends at 10am	 (listValue (filter (filter (getProperty (singleton en.meeting) (string !type)) (string end_time) (string =) (time 10 0)) (string attendee) (string =) en.person.alice))
show me all meetings beginning at 3 pm at latest	 (listValue (filter (getProperty (singleton en.meeting) (string !type)) (ensureNumericProperty (string start_time)) (string <=) (ensureNumericEntity (concat (time 10 0) (time 15 0)))))
which meeting has the earliest end time	 (listValue (superlative (getProperty (singleton en.meeting) (string !type)) (string min) (ensureNumericProperty (string end_time))))
what important meeting started at 10am	 (listValue (filter (filter (getProperty (singleton en.meeting) (string !type)) (string is_important)) (string start_time) (string =) (time 10 0)))
meetings that end at or after 10am	 (listValue (filter (getProperty (singleton en.meeting) (string !type)) (ensureNumericProperty (string end_time)) (string >=) (ensureNumericEntity (time 10 0))))
which location hosts the most meetings	 (listValue (countSuperlative (getProperty (singleton en.location) (string !type)) (string max) (reverse (string location)) (getProperty (singleton en.meeting) (string !type))))
show me all meetings that start no earlier than when the weekly standup meeting ends	 (listValue (filter (getProperty (singleton en.meeting) (string !type)) (ensureNumericProperty (string start_time)) (string <=) (ensureNumericEntity (getProperty en.meeting.weekly_standup (string end_time)))))
show me all meetings happening on or after the date of the weekly standup	 (listValue (filter (getProperty (singleton en.meeting) (string !type)) (ensureNumericProperty (string date)) (string >=) (ensureNumericEntity (getProperty en.meeting.weekly_standup (string date)))))
show me all meetings that start later than 10 am	 (listValue (filter (getProperty (singleton en.meeting) (string !type)) (ensureNumericProperty (string start_time)) (string >) (ensureNumericEntity (time 10 0))))
show me the meeting that starts at 10 am on january 2	 (listValue (filter (filter (getProperty (singleton en.meeting) (string !type)) (string date) (string =) (date 2015 1 2)) (string start_time) (string =) (time 10 0)))
is this meeting three hours long or an hour long	 (listValue (concat (number 3 en.hour) (number 1 en.hour)))
show me all meetings alice has attended which begin at 10 am	 (listValue (filter (filter (getProperty (singleton en.meeting) (string !type)) (string start_time) (string =) (time 10 0)) (string attendee) (string =) en.person.alice))
meeting held before the weekly standup meeting	 (listValue (filter (getProperty (singleton en.meeting) (string !type)) (ensureNumericProperty (string date)) (string <) (ensureNumericEntity (getProperty en.meeting.weekly_standup (string date)))))
meetings ending at 10 am that are three hours long	 (listValue (filter (filter (getProperty (singleton en.meeting) (string !type)) (string length) (string =) (number 3 en.hour)) (string end_time) (string =) (time 10 0)))
show me all meetings happening after the weekly standup	 (listValue (filter (getProperty (singleton en.meeting) (string !type)) (ensureNumericProperty (string date)) (string >) (ensureNumericEntity (getProperty en.meeting.weekly_standup (string date)))))
meeting ends no later than start time of weekly standup	 (listValue (filter (getProperty (singleton en.meeting) (string !type)) (ensureNumericProperty (string end_time)) (string <=) (ensureNumericEntity (getProperty en.meeting.weekly_standup (string start_time)))))
show me any meetings located at greenberg cafe or central office	 (listValue (filter (getProperty (singleton en.meeting) (string !type)) (string location) (string =) (concat en.location.greenberg_cafe en.location.central_office)))
what meeting is one hour or longer	 (listValue (filter (getProperty (singleton en.meeting) (string !type)) (ensureNumericProperty (string length)) (string >=) (ensureNumericEntity (concat (number 3 en.hour) (number 1 en.hour)))))
three hour meeting that ends at 10am	 (listValue (filter (filter (getProperty (singleton en.meeting) (string !type)) (string end_time) (string =) (time 10 0)) (string length) (string =) (number 3 en.hour)))
meeting no longer than duration of weekly standup	 (listValue (filter (getProperty (singleton en.meeting) (string !type)) (ensureNumericProperty (string length)) (string <=) (ensureNumericEntity (getProperty en.meeting.weekly_standup (string length)))))
show me all meetings with lengths that either less or more than three hours	 (listValue (filter (getProperty (singleton en.meeting) (string !type)) (string length) (string !=) (number 3 en.hour)))
show me the meetings which end no later than the weekly standup ends	 (listValue (filter (getProperty (singleton en.meeting) (string !type)) (ensureNumericProperty (string end_time)) (string <=) (ensureNumericEntity (getProperty en.meeting.weekly_standup (string end_time)))))
when does the weekly standup meeting begin	 (listValue (getProperty en.meeting.weekly_standup (string start_time)))
what meeting has an earlier date than jan 2	 (listValue (filter (getProperty (singleton en.meeting) (string !type)) (ensureNumericProperty (string date)) (string <) (ensureNumericEntity (date 2015 1 2))))
show me all meetings beginning earlier than the weekly standup	 (listValue (filter (getProperty (singleton en.meeting) (string !type)) (ensureNumericProperty (string start_time)) (string <) (ensureNumericEntity (getProperty en.meeting.weekly_standup (string start_time)))))
show me all meetings that alice is not attending	 (listValue (filter (getProperty (singleton en.meeting) (string !type)) (string attendee) (string !=) en.person.alice))
person who attends the meeting that ends at 10 am	 (listValue (filter (getProperty (singleton en.person) (string !type)) (reverse (string attendee)) (string =) (filter (getProperty (singleton en.meeting) (string !type)) (string end_time) (string =) (time 10 0))))
meetings attended by two people	 (listValue (countComparative (getProperty (singleton en.meeting) (string !type)) (string attendee) (string =) (number 2)))
what person is an attendee of at least two meetings	 (listValue (countComparative (getProperty (singleton en.person) (string !type)) (reverse (string attendee)) (string >=) (number 2) (getProperty (singleton en.meeting) (string !type))))
what is the location of the meeting that alice is attending	 (listValue (filter (getProperty (singleton en.location) (string !type)) (reverse (string location)) (string =) (filter (getProperty (singleton en.meeting) (string !type)) (string attendee) (string =) en.person.alice)))
show me all meetings in greenberg cafe or central office	 (listValue (filter (getProperty (singleton en.meeting) (string !type)) (string location) (string =) (concat en.location.greenberg_cafe en.location.central_office)))
meeting whose start time is after end time of weekly standup	 (listValue (filter (getProperty (singleton en.meeting) (string !type)) (ensureNumericProperty (string start_time)) (string >) (ensureNumericEntity (getProperty en.meeting.weekly_standup (string end_time)))))
show meetings that start at 10am in greenberg cafe	 (listValue (filter (filter (getProperty (singleton en.meeting) (string !type)) (string start_time) (string =) (time 10 0)) (string location) (string =) en.location.greenberg_cafe))
what meeting has the latest start time	 (listValue (superlative (getProperty (singleton en.meeting) (string !type)) (string max) (ensureNumericProperty (string start_time))))
what meeting is located at greenberg cafe and alice will be attending	 (listValue (filter (filter (getProperty (singleton en.meeting) (string !type)) (string attendee) (string =) en.person.alice) (string location) (string =) en.location.greenberg_cafe))
what is the shortest meeting	 (listValue (superlative (getProperty (singleton en.meeting) (string !type)) (string min) (ensureNumericProperty (string length))))
show me any meetings which end at 10 am	 (listValue (filter (getProperty (singleton en.meeting) (string !type)) (string end_time) (string =) (time 10 0)))
meetings that are the same length or shorter than the weekly standup meeting	 (listValue (filter (getProperty (singleton en.meeting) (string !type)) (ensureNumericProperty (string length)) (string <=) (ensureNumericEntity (getProperty en.meeting.weekly_standup (string length)))))
show me meetings that have the same location as weekly startup	 (listValue (filter (getProperty (singleton en.meeting) (string !type)) (string location) (string =) (getProperty en.meeting.weekly_standup (string location))))
show me all meetings three hours long which are marked as important	 (listValue (filter (filter (getProperty (singleton en.meeting) (string !type)) (string length) (string =) (number 3 en.hour)) (string is_important)))
what is the location that the most number of meetings will be held	 (listValue (countSuperlative (getProperty (singleton en.location) (string !type)) (string max) (reverse (string location)) (getProperty (singleton en.meeting) (string !type))))
what meeting has two locations	 (listValue (countComparative (getProperty (singleton en.meeting) (string !type)) (string location) (string <=) (number 2)))
show me meetings starting before 3pm	 (listValue (filter (getProperty (singleton en.meeting) (string !type)) (ensureNumericProperty (string start_time)) (string <=) (ensureNumericEntity (concat (time 10 0) (time 15 0)))))
show me all meetings which end later than 10 am	 (listValue (filter (getProperty (singleton en.meeting) (string !type)) (ensureNumericProperty (string end_time)) (string >) (ensureNumericEntity (time 10 0))))
who has attended the least number of meetings	 (listValue (countSuperlative (getProperty (singleton en.person) (string !type)) (string min) (reverse (string attendee)) (getProperty (singleton en.meeting) (string !type))))
show me all meetings attended by people who have also attended the weekly standup	 (listValue (filter (getProperty (singleton en.meeting) (string !type)) (string attendee) (string =) (filter (getProperty (singleton en.person) (string !type)) (reverse (string attendee)) (string =) en.meeting.weekly_standup)))
people that attend meetings at greenberg cafe	 (listValue (filter (getProperty (singleton en.person) (string !type)) (reverse (string attendee)) (string =) (filter (getProperty (singleton en.meeting) (string !type)) (string location) (string =) en.location.greenberg_cafe)))
meetings held before january 2 or january 3	 (listValue (filter (getProperty (singleton en.meeting) (string !type)) (ensureNumericProperty (string date)) (string <) (ensureNumericEntity (concat (date 2015 1 2) (date 2015 1 3)))))
two attendees are at the meeting	 (listValue (countComparative (getProperty (singleton en.meeting) (string !type)) (string attendee) (string =) (number 2)))
show me any meetings that are either the weekly standup or annual review	 (listValue (concat en.meeting.weekly_standup en.meeting.annual_review))
what is the location of the meting with least number of attendees	 (listValue (countSuperlative (getProperty (singleton en.location) (string !type)) (string min) (reverse (string location)) (getProperty (singleton en.meeting) (string !type))))
meeting occurs on later date than weekly standup	 (listValue (filter (getProperty (singleton en.meeting) (string !type)) (ensureNumericProperty (string date)) (string >) (ensureNumericEntity (getProperty en.meeting.weekly_standup (string date)))))
show all meetings that start ealier than 10am	 (listValue (filter (getProperty (singleton en.meeting) (string !type)) (ensureNumericProperty (string start_time)) (string <) (ensureNumericEntity (time 10 0))))
important meetings that are three hours long	 (listValue (filter (filter (getProperty (singleton en.meeting) (string !type)) (string length) (string =) (number 3 en.hour)) (string is_important)))
what location is the meeting that ends at 10am	 (listValue (filter (getProperty (singleton en.location) (string !type)) (reverse (string location)) (string =) (filter (getProperty (singleton en.meeting) (string !type)) (string end_time) (string =) (time 10 0))))
meetings held at greenberg cafe or central office	 (listValue (filter (getProperty (singleton en.meeting) (string !type)) (string location) (string =) (concat en.location.greenberg_cafe en.location.central_office)))
what meetings are the same day as the weekly standup meeting	 (listValue (filter (getProperty (singleton en.meeting) (string !type)) (string date) (string =) (getProperty en.meeting.weekly_standup (string date))))
show me important meetings on jan 2	 (listValue (filter (filter (getProperty (singleton en.meeting) (string !type)) (string date) (string =) (date 2015 1 2)) (string is_important)))
what is the location of the important meeting	 (listValue (filter (getProperty (singleton en.location) (string !type)) (reverse (string location)) (string =) (filter (getProperty (singleton en.meeting) (string !type)) (string is_important))))
meetings that start at or before the time of the weekly standup meeting	 (listValue (filter (getProperty (singleton en.meeting) (string !type)) (ensureNumericProperty (string start_time)) (string <=) (ensureNumericEntity (getProperty en.meeting.weekly_standup (string start_time)))))
three or one hours	 (listValue (concat (number 3 en.hour) (number 1 en.hour)))
what meeting has a later date than weekly standup	 (listValue (filter (getProperty (singleton en.meeting) (string !type)) (ensureNumericProperty (string date)) (string >) (ensureNumericEntity (getProperty en.meeting.weekly_standup (string date)))))
weekly standup duration	 (listValue (getProperty en.meeting.weekly_standup (string length)))
what meeting is no greater than one to three hours	 (listValue (filter (getProperty (singleton en.meeting) (string !type)) (ensureNumericProperty (string length)) (string <=) (ensureNumericEntity (concat (number 3 en.hour) (number 1 en.hour)))))
show me all meetings happening on or after january 2nd	 (listValue (filter (getProperty (singleton en.meeting) (string !type)) (ensureNumericProperty (string date)) (string >=) (ensureNumericEntity (date 2015 1 2))))
location of at least two meetings is the location	 (listValue (countComparative (getProperty (singleton en.location) (string !type)) (reverse (string location)) (string >=) (number 2) (getProperty (singleton en.meeting) (string !type))))
show me all 10am meetings that alice is attending	 (listValue (filter (filter (getProperty (singleton en.meeting) (string !type)) (string start_time) (string =) (time 10 0)) (string attendee) (string =) en.person.alice))
show me all attendees of meetings at the greenberg cafe	 (listValue (filter (getProperty (singleton en.person) (string !type)) (reverse (string attendee)) (string =) (filter (getProperty (singleton en.meeting) (string !type)) (string location) (string =) en.location.greenberg_cafe)))
which meetings have the same start time as the weekly standup meeting	 (listValue (filter (getProperty (singleton en.meeting) (string !type)) (string start_time) (string =) (getProperty en.meeting.weekly_standup (string start_time))))
which meeting is attended by the most people	 (listValue (countSuperlative (getProperty (singleton en.meeting) (string !type)) (string max) (string attendee)))
meetings that end before 10am	 (listValue (filter (getProperty (singleton en.meeting) (string !type)) (ensureNumericProperty (string end_time)) (string <) (ensureNumericEntity (time 10 0))))
show me all meetings that start earlier than the weekly standup meeting	 (listValue (filter (getProperty (singleton en.meeting) (string !type)) (ensureNumericProperty (string start_time)) (string <=) (ensureNumericEntity (getProperty en.meeting.weekly_standup (string start_time)))))
what meeting has the later date	 (listValue (superlative (getProperty (singleton en.meeting) (string !type)) (string max) (ensureNumericProperty (string date))))
meetings held on or before the weekly standup meeting	 (listValue (filter (getProperty (singleton en.meeting) (string !type)) (ensureNumericProperty (string date)) (string <=) (ensureNumericEntity (getProperty en.meeting.weekly_standup (string date)))))
show me meetings before the weekly standup	 (listValue (filter (getProperty (singleton en.meeting) (string !type)) (ensureNumericProperty (string date)) (string <=) (ensureNumericEntity (getProperty en.meeting.weekly_standup (string date)))))
meeting which has longest end time	 (listValue (superlative (getProperty (singleton en.meeting) (string !type)) (string max) (ensureNumericProperty (string end_time))))
show me all meetings that end at the same time or earlier than the weekly standup meeting	 (listValue (filter (getProperty (singleton en.meeting) (string !type)) (ensureNumericProperty (string end_time)) (string <=) (ensureNumericEntity (getProperty en.meeting.weekly_standup (string end_time)))))
show me all meetings which alice has attended that end at 10 am	 (listValue (filter (filter (getProperty (singleton en.meeting) (string !type)) (string end_time) (string =) (time 10 0)) (string attendee) (string =) en.person.alice))
how many meetings are scheduled	 (listValue (call .size (getProperty (singleton en.meeting) (string !type))))
show me all meetings that last longer than three hours	 (listValue (filter (getProperty (singleton en.meeting) (string !type)) (ensureNumericProperty (string length)) (string >) (ensureNumericEntity (concat (number 3 en.hour) (number 1 en.hour)))))
what meeting has an end time greater than weekly standup	 (listValue (filter (getProperty (singleton en.meeting) (string !type)) (ensureNumericProperty (string end_time)) (string >) (ensureNumericEntity (getProperty en.meeting.weekly_standup (string start_time)))))
what meeting ends at 10am in which alice is attending	 (listValue (filter (filter (getProperty (singleton en.meeting) (string !type)) (string end_time) (string =) (time 10 0)) (string attendee) (string =) en.person.alice))
show me all meetings that start no later than 10am	 (listValue (filter (getProperty (singleton en.meeting) (string !type)) (ensureNumericProperty (string start_time)) (string <=) (ensureNumericEntity (time 10 0))))
what important meeting has a length of three hours	 (listValue (filter (filter (getProperty (singleton en.meeting) (string !type)) (string length) (string =) (number 3 en.hour)) (string is_important)))
what meeting starts earlier than 10am	 (listValue (filter (getProperty (singleton en.meeting) (string !type)) (ensureNumericProperty (string start_time)) (string <) (ensureNumericEntity (time 10 0))))
what meetings date is earlier than jan 2 or 3rd	 (listValue (filter (getProperty (singleton en.meeting) (string !type)) (ensureNumericProperty (string date)) (string <) (ensureNumericEntity (concat (date 2015 1 2) (date 2015 1 3)))))
show me all meetings that start no earlier than the weekly standup meeting	 (listValue (filter (getProperty (singleton en.meeting) (string !type)) (ensureNumericProperty (string date)) (string >=) (ensureNumericEntity (getProperty en.meeting.weekly_standup (string date)))))
show me all meetings that end after the weekly stand up meeting starts	 (listValue (filter (getProperty (singleton en.meeting) (string !type)) (ensureNumericProperty (string end_time)) (string >) (ensureNumericEntity (getProperty en.meeting.weekly_standup (string start_time)))))
what is the number of the meeting	 (listValue (call .size (getProperty (singleton en.meeting) (string !type))))
meetings with the latest end time	 (listValue (superlative (getProperty (singleton en.meeting) (string !type)) (string max) (ensureNumericProperty (string end_time))))
locations of meetings attended by alice	 (listValue (filter (getProperty (singleton en.location) (string !type)) (reverse (string location)) (string =) (filter (getProperty (singleton en.meeting) (string !type)) (string attendee) (string =) en.person.alice)))
three hour long meeting at greenberg	 (listValue (filter (filter (getProperty (singleton en.meeting) (string !type)) (string location) (string =) en.location.greenberg_cafe) (string length) (string =) (number 3 en.hour)))
important meeting with alice as attendee	 (listValue (filter (filter (getProperty (singleton en.meeting) (string !type)) (string is_important)) (string attendee) (string =) en.person.alice))
meeting of smallest duration	 (listValue (superlative (getProperty (singleton en.meeting) (string !type)) (string min) (ensureNumericProperty (string end_time))))
show me meetings on jan 2 with alice	 (listValue (filter (filter (getProperty (singleton en.meeting) (string !type)) (string attendee) (string =) en.person.alice) (string date) (string =) (date 2015 1 2)))
person that attends the fewest meetings	 (listValue (countSuperlative (getProperty (singleton en.person) (string !type)) (string min) (reverse (string attendee)) (getProperty (singleton en.meeting) (string !type))))
january 2nd or 3rd	 (listValue (concat (date 2015 1 2) (date 2015 1 3)))
show me the length of the weekly standup	 (listValue (getProperty en.meeting.weekly_standup (string length)))
show me all meetings happening on or before january 2nd	 (listValue (filter (getProperty (singleton en.meeting) (string !type)) (ensureNumericProperty (string date)) (string <=) (ensureNumericEntity (date 2015 1 2))))
show me all meetings marked as important happening at greenberg cafe	 (listValue (filter (filter (getProperty (singleton en.meeting) (string !type)) (string is_important)) (string location) (string =) en.location.greenberg_cafe))
meeting which starts at 10 am at greenberg cafe	 (listValue (filter (filter (getProperty (singleton en.meeting) (string !type)) (string location) (string =) en.location.greenberg_cafe) (string start_time) (string =) (time 10 0)))
meeting that starts at 10am or earlier	 (listValue (filter (getProperty (singleton en.meeting) (string !type)) (ensureNumericProperty (string start_time)) (string >=) (ensureNumericEntity (time 10 0))))
meetings that are three hours long or one hour long	 (listValue (filter (getProperty (singleton en.meeting) (string !type)) (string length) (string =) (concat (number 3 en.hour) (number 1 en.hour))))
location where more than two meetings are held	 (listValue (countComparative (getProperty (singleton en.location) (string !type)) (reverse (string location)) (string >) (number 2) (getProperty (singleton en.meeting) (string !type))))
meeting with largest number of locations	 (listValue (countSuperlative (getProperty (singleton en.meeting) (string !type)) (string max) (string location)))
what meeting will take place no later than jan 2	 (listValue (filter (getProperty (singleton en.meeting) (string !type)) (ensureNumericProperty (string date)) (string <=) (ensureNumericEntity (date 2015 1 2))))
where are the meetings ending at 10am going to be held	 (listValue (filter (getProperty (singleton en.location) (string !type)) (reverse (string location)) (string =) (filter (getProperty (singleton en.meeting) (string !type)) (string end_time) (string =) (time 10 0))))
what meeting has a start time at 10am at greenberg cafe	 (listValue (filter (filter (getProperty (singleton en.meeting) (string !type)) (string start_time) (string =) (time 10 0)) (string location) (string =) en.location.greenberg_cafe))
show me meetings that share location with the weekly standup meeting	 (listValue (filter (getProperty (singleton en.meeting) (string !type)) (string location) (string =) (filter (getProperty (singleton en.location) (string !type)) (reverse (string location)) (string =) en.meeting.weekly_standup)))
what is the average length of a meeting	 (listValue (aggregate (string avg) (getProperty (getProperty (singleton en.meeting) (string !type)) (string length))))
what time does the weekly standup meeting end	 (listValue (getProperty en.meeting.weekly_standup (string end_time)))
what meeting is before weekly standup	 (listValue (filter (getProperty (singleton en.meeting) (string !type)) (ensureNumericProperty (string date)) (string <) (ensureNumericEntity (getProperty en.meeting.weekly_standup (string date)))))
show me all meetings in greenber cafe that will run three hours	 (listValue (filter (filter (getProperty (singleton en.meeting) (string !type)) (string length) (string =) (number 3 en.hour)) (string location) (string =) en.location.greenberg_cafe))
what meeting is on or before jan 2 or 3rd	 (listValue (filter (getProperty (singleton en.meeting) (string !type)) (ensureNumericProperty (string date)) (string <=) (ensureNumericEntity (concat (date 2015 1 2) (date 2015 1 3)))))
which meeting has the fewest scheduled locations	 (listValue (countSuperlative (getProperty (singleton en.meeting) (string !type)) (string min) (string location)))
weekly standup start time	 (listValue (getProperty en.meeting.weekly_standup (string start_time)))
meetings that are three hours long or less	 (listValue (filter (getProperty (singleton en.meeting) (string !type)) (ensureNumericProperty (string length)) (string <=) (ensureNumericEntity (number 3 en.hour))))
meetings that are not three hours long	 (listValue (filter (getProperty (singleton en.meeting) (string !type)) (string length) (string !=) (number 3 en.hour)))
what meeting has the length of most weekly startup meetings	 (listValue (filter (getProperty (singleton en.meeting) (string !type)) (ensureNumericProperty (string length)) (string <=) (ensureNumericEntity (getProperty en.meeting.weekly_standup (string length)))))
show me meetings that start before the weekly standup meeting ends	 (listValue (filter (getProperty (singleton en.meeting) (string !type)) (ensureNumericProperty (string start_time)) (string >=) (ensureNumericEntity (getProperty en.meeting.weekly_standup (string end_time)))))
where is the weekly standup meeting located	 (listValue (getProperty en.meeting.weekly_standup (string location)))
schedule a meeting for 10am or 3pm	 (listValue (concat (time 10 0) (time 15 0)))
show me all meetings that are either weekly standup or annual review	 (listValue (concat en.meeting.weekly_standup en.meeting.annual_review))
what meeting is not on jan 2	 (listValue (filter (getProperty (singleton en.meeting) (string !type)) (string date) (string !=) (date 2015 1 2)))
meetings that start after 10am	 (listValue (filter (getProperty (singleton en.meeting) (string !type)) (ensureNumericProperty (string start_time)) (string >) (ensureNumericEntity (time 10 0))))
meetings attended by two or more people	 (listValue (countComparative (getProperty (singleton en.meeting) (string !type)) (string attendee) (string >=) (number 2)))
is this meeting on january 2 or january 3	 (listValue (concat (date 2015 1 2) (date 2015 1 3)))
meetings that start at 10am or 3pm	 (listValue (filter (getProperty (singleton en.meeting) (string !type)) (string start_time) (string =) (concat (time 10 0) (time 15 0))))
people that attend three hour long meetings	 (listValue (filter (getProperty (singleton en.person) (string !type)) (reverse (string attendee)) (string =) (filter (getProperty (singleton en.meeting) (string !type)) (string length) (string =) (number 3 en.hour))))
which person is attending an important meeting	 (listValue (filter (getProperty (singleton en.person) (string !type)) (reverse (string attendee)) (string =) (filter (getProperty (singleton en.meeting) (string !type)) (string is_important))))
show me the meetings which are latest in the month	 (listValue (superlative (getProperty (singleton en.meeting) (string !type)) (string max) (ensureNumericProperty (string date))))
find me a meeting that is three hours long	 (listValue (filter (getProperty (singleton en.meeting) (string !type)) (string length) (string =) (number 3 en.hour)))
what person is attending weekly standup	 (listValue (filter (filter (getProperty (singleton en.person) (string !type)) (reverse (string attendee)) (string =) en.meeting.weekly_standup) (reverse (string attendee)) (string =) en.meeting.weekly_standup))
meetings with the earliest start time	 (listValue (superlative (getProperty (singleton en.meeting) (string !type)) (string min) (ensureNumericProperty (string start_time))))
what is the location of weekly startup	 (listValue (filter (filter (getProperty (singleton en.location) (string !type)) (reverse (string location)) (string =) en.meeting.weekly_standup) (reverse (string location)) (string =) en.meeting.weekly_standup))
how long is this meeting	 (listValue (aggregate (string sum) (getProperty (getProperty (singleton en.meeting) (string !type)) (string length))))
show me all meetings beginning no later than 10 am or 3 pm	 (listValue (filter (getProperty (singleton en.meeting) (string !type)) (ensureNumericProperty (string start_time)) (string >=) (ensureNumericEntity (concat (time 10 0) (time 15 0)))))
what important meeting is alice attending	 (listValue (filter (filter (getProperty (singleton en.meeting) (string !type)) (string attendee) (string =) en.person.alice) (string is_important)))
show me all meetings not happening at greenberg cafe	 (listValue (filter (getProperty (singleton en.meeting) (string !type)) (string location) (string !=) en.location.greenberg_cafe))
who attends the most meetings	 (listValue (countSuperlative (getProperty (singleton en.person) (string !type)) (string max) (reverse (string attendee)) (getProperty (singleton en.meeting) (string !type))))
what meeting was shorter or longer than three hours	 (listValue (filter (getProperty (singleton en.meeting) (string !type)) (string length) (string !=) (number 3 en.hour)))
show me all three hour meetings that end at 10am	 (listValue (filter (filter (getProperty (singleton en.meeting) (string !type)) (string length) (string =) (number 3 en.hour)) (string end_time) (string =) (time 10 0)))
show me all meetings beginning at 10 am and all meetings ending at 10 am	 (listValue (filter (filter (getProperty (singleton en.meeting) (string !type)) (string end_time) (string =) (time 10 0)) (string end_time) (string =) (time 10 0)))
what important meetings are scheduled for jan 2	 (listValue (filter (filter (getProperty (singleton en.meeting) (string !type)) (string is_important)) (string date) (string =) (date 2015 1 2)))
show me meetings on jan 2 in greenberg cafe	 (listValue (filter (filter (getProperty (singleton en.meeting) (string !type)) (string date) (string =) (date 2015 1 2)) (string location) (string =) en.location.greenberg_cafe))
meetings that do not start at 10am	 (listValue (filter (getProperty (singleton en.meeting) (string !type)) (string start_time) (string !=) (time 10 0)))
who attends weekly standup	 (listValue (filter (getProperty (singleton en.person) (string !type)) (reverse (string attendee)) (string =) en.meeting.weekly_standup))
duration of meeting	 (listValue (aggregate (string sum) (getProperty (getProperty (singleton en.meeting) (string !type)) (string length))))
show me all meetings beginning at 10 am	 (listValue (filter (filter (getProperty (singleton en.meeting) (string !type)) (string start_time) (string =) (time 10 0)) (string start_time) (string =) (time 10 0)))
show me important meetings with alice	 (listValue (filter (filter (getProperty (singleton en.meeting) (string !type)) (string is_important)) (string attendee) (string =) en.person.alice))
show me the meetings that start later than the weekly standup meeting	 (listValue (filter (getProperty (singleton en.meeting) (string !type)) (ensureNumericProperty (string start_time)) (string >) (ensureNumericEntity (getProperty en.meeting.weekly_standup (string start_time)))))
show me all meetings scheduled to run for 3 hours	 (listValue (filter (getProperty (singleton en.meeting) (string !type)) (ensureNumericProperty (string length)) (string <=) (ensureNumericEntity (number 3 en.hour))))
what meetings have the same date as the weekly standup meeting	 (listValue (filter (getProperty (singleton en.meeting) (string !type)) (string date) (string =) (getProperty en.meeting.weekly_standup (string date))))
what is the length of the meeting	 (listValue (aggregate (string sum) (getProperty (getProperty (singleton en.meeting) (string !type)) (string length))))
what person is attending the meeting at greenberg cafe	 (listValue (filter (getProperty (singleton en.person) (string !type)) (reverse (string attendee)) (string =) (filter (getProperty (singleton en.meeting) (string !type)) (string location) (string =) en.location.greenberg_cafe)))
show me all meetings happening on days before the weekly standup	 (listValue (filter (getProperty (singleton en.meeting) (string !type)) (ensureNumericProperty (string date)) (string <) (ensureNumericEntity (getProperty en.meeting.weekly_standup (string date)))))
who is attending weekly standup	 (listValue (getProperty en.meeting.weekly_standup (string attendee)))
show me all meetings on january 2nd which are also 3 hours long	 (listValue (filter (filter (getProperty (singleton en.meeting) (string !type)) (string length) (string =) (number 3 en.hour)) (string date) (string =) (date 2015 1 2)))
show me all meetings scheduled for three hourse	 (listValue (filter (filter (getProperty (singleton en.meeting) (string !type)) (string length) (string =) (number 3 en.hour)) (string length) (string =) (number 3 en.hour)))
people that attend more than two meetings	 (listValue (countComparative (getProperty (singleton en.person) (string !type)) (reverse (string attendee)) (string >) (number 2) (getProperty (singleton en.meeting) (string !type))))
what meeting has a start time earlier than the weekly standup	 (listValue (filter (getProperty (singleton en.meeting) (string !type)) (ensureNumericProperty (string start_time)) (string <) (ensureNumericEntity (getProperty en.meeting.weekly_standup (string start_time)))))
what meeting ending at 10am is alice attending	 (listValue (filter (filter (getProperty (singleton en.meeting) (string !type)) (string attendee) (string =) en.person.alice) (string end_time) (string =) (time 10 0)))
start time of the meeting is after the start time of weekly standup	 (listValue (filter (getProperty (singleton en.meeting) (string !type)) (ensureNumericProperty (string start_time)) (string >) (ensureNumericEntity (getProperty en.meeting.weekly_standup (string start_time)))))
meeting on jan 2nd with alice as attendee	 (listValue (filter (filter (getProperty (singleton en.meeting) (string !type)) (string attendee) (string =) en.person.alice) (string date) (string =) (date 2015 1 2)))
show me all meetings starting at or before 10 am	 (listValue (filter (getProperty (singleton en.meeting) (string !type)) (ensureNumericProperty (string start_time)) (string <=) (ensureNumericEntity (time 10 0))))
show me all meetings marked important which end at 10 am	 (listValue (filter (filter (getProperty (singleton en.meeting) (string !type)) (string end_time) (string =) (time 10 0)) (string is_important)))
meetings on january 2 that are three hours long	 (listValue (filter (filter (getProperty (singleton en.meeting) (string !type)) (string length) (string =) (number 3 en.hour)) (string date) (string =) (date 2015 1 2)))
what is the number of the location	 (listValue (call .size (getProperty (singleton en.location) (string !type))))
what meeting has the same length as weekly startup	 (listValue (filter (getProperty (singleton en.meeting) (string !type)) (ensureNumericProperty (string length)) (string >=) (ensureNumericEntity (getProperty en.meeting.weekly_standup (string length)))))
show me meetings not at greenberg cafe	 (listValue (filter (getProperty (singleton en.meeting) (string !type)) (string location) (string !=) en.location.greenberg_cafe))
important meeting alice is attending	 (listValue (filter (filter (getProperty (singleton en.meeting) (string !type)) (string attendee) (string =) en.person.alice) (string is_important)))
three hour meeting	 (listValue (filter (filter (getProperty (singleton en.meeting) (string !type)) (string length) (string =) (number 3 en.hour)) (string length) (string =) (number 3 en.hour)))
show me meetings starting before 10am	 (listValue (filter (getProperty (singleton en.meeting) (string !type)) (ensureNumericProperty (string start_time)) (string <=) (ensureNumericEntity (time 10 0))))
important meetings at greenberg cafe	 (listValue (filter (filter (getProperty (singleton en.meeting) (string !type)) (string is_important)) (string location) (string =) en.location.greenberg_cafe))
show me any meetings on january 2 beginning at 10 am	 (listValue (filter (filter (getProperty (singleton en.meeting) (string !type)) (string start_time) (string =) (time 10 0)) (string date) (string =) (date 2015 1 2)))
who is attending the meeting on jan 2	 (listValue (filter (getProperty (singleton en.person) (string !type)) (reverse (string attendee)) (string =) (filter (getProperty (singleton en.meeting) (string !type)) (string date) (string =) (date 2015 1 2))))
what time does the weekly standup meeting start	 (listValue (getProperty en.meeting.weekly_standup (string start_time)))
meetings held on or after january 2	 (listValue (filter (getProperty (singleton en.meeting) (string !type)) (ensureNumericProperty (string date)) (string >=) (ensureNumericEntity (date 2015 1 2))))
show me all meetings happening at the same location as the weekly standup	 (listValue (filter (getProperty (singleton en.meeting) (string !type)) (string location) (string =) (filter (getProperty (singleton en.location) (string !type)) (reverse (string location)) (string =) en.meeting.weekly_standup)))
show me all meetings which begin earlier than 10 am or 3 pm	 (listValue (filter (getProperty (singleton en.meeting) (string !type)) (ensureNumericProperty (string start_time)) (string <) (ensureNumericEntity (concat (time 10 0) (time 15 0)))))
what meeting ends at 10am or 3pm	 (listValue (filter (getProperty (singleton en.meeting) (string !type)) (ensureNumericProperty (string end_time)) (string >=) (ensureNumericEntity (concat (time 10 0) (time 15 0)))))
show me the people who attend the most meetings	 (listValue (countSuperlative (getProperty (singleton en.person) (string !type)) (string max) (reverse (string attendee)) (getProperty (singleton en.meeting) (string !type))))
meeting which is on the date of first weekly standup	 (listValue (filter (getProperty (singleton en.meeting) (string !type)) (ensureNumericProperty (string date)) (string >=) (ensureNumericEntity (getProperty en.meeting.weekly_standup (string date)))))
what is the number of the person	 (listValue (call .size (getProperty (singleton en.person) (string !type))))
who is attending the greenberg cafe for the meeting	 (listValue (filter (getProperty (singleton en.person) (string !type)) (reverse (string attendee)) (string =) (filter (getProperty (singleton en.meeting) (string !type)) (string location) (string =) en.location.greenberg_cafe)))
meeting starts at 700 am and ends at 000 am	 (listValue (filter (filter (getProperty (singleton en.meeting) (string !type)) (string length) (string =) (number 3 en.hour)) (string end_time) (string =) (time 10 0)))
what meeting has a start time no later than 10am or 3pm	 (listValue (filter (getProperty (singleton en.meeting) (string !type)) (ensureNumericProperty (string start_time)) (string <=) (ensureNumericEntity (concat (time 10 0) (time 15 0)))))
who is attending the 10 am meeting	 (listValue (filter (getProperty (singleton en.person) (string !type)) (reverse (string attendee)) (string =) (filter (getProperty (singleton en.meeting) (string !type)) (string start_time) (string =) (time 10 0))))
show me meetings before january 2nd	 (listValue (filter (getProperty (singleton en.meeting) (string !type)) (ensureNumericProperty (string date)) (string <) (ensureNumericEntity (date 2015 1 2))))
show me all metings that take place jan 2 or jan 3	 (listValue (filter (getProperty (singleton en.meeting) (string !type)) (string date) (string =) (concat (date 2015 1 2) (date 2015 1 3))))
show me all meetings that share an attendee with the weekly standup meeting	 (listValue (filter (getProperty (singleton en.meeting) (string !type)) (string attendee) (string =) (filter (getProperty (singleton en.person) (string !type)) (reverse (string attendee)) (string =) en.meeting.weekly_standup)))
show me all meetings that start at 10am on jan 2	 (listValue (filter (filter (getProperty (singleton en.meeting) (string !type)) (string start_time) (string =) (time 10 0)) (string date) (string =) (date 2015 1 2)))
show me all meetings which end earlier than the weekly standup begins	 (listValue (filter (getProperty (singleton en.meeting) (string !type)) (ensureNumericProperty (string end_time)) (string <) (ensureNumericEntity (getProperty en.meeting.weekly_standup (string start_time)))))
what meeting is alice attending at 10am	 (listValue (filter (filter (getProperty (singleton en.meeting) (string !type)) (string attendee) (string =) en.person.alice) (string start_time) (string =) (time 10 0)))
meetings with the latest start time	 (listValue (superlative (getProperty (singleton en.meeting) (string !type)) (string max) (ensureNumericProperty (string start_time))))
show me any meetings which alice has attended and take place at greenberg cafe	 (listValue (filter (filter (getProperty (singleton en.meeting) (string !type)) (string location) (string =) en.location.greenberg_cafe) (string attendee) (string =) en.person.alice))
show me all meetings that end at 10am and start at 10am	 (listValue (filter (filter (getProperty (singleton en.meeting) (string !type)) (string end_time) (string =) (time 10 0)) (string start_time) (string =) (time 10 0)))
what meeting has a date of jan 2 and has alice attending	 (listValue (filter (filter (getProperty (singleton en.meeting) (string !type)) (string date) (string =) (date 2015 1 2)) (string attendee) (string =) en.person.alice))
show me meetings at greenberg cafe	 (listValue (filter (filter (getProperty (singleton en.meeting) (string !type)) (string location) (string =) en.location.greenberg_cafe) (string location) (string =) en.location.greenberg_cafe))
what meeting has the most amount of locations	 (listValue (countSuperlative (getProperty (singleton en.meeting) (string !type)) (string max) (string location)))
meeting at location of weekly standup	 (listValue (filter (getProperty (singleton en.meeting) (string !type)) (string location) (string =) (getProperty en.meeting.weekly_standup (string location))))
meeting that starts and ends at 10am	 (listValue (filter (filter (getProperty (singleton en.meeting) (string !type)) (string start_time) (string =) (time 10 0)) (string end_time) (string =) (time 10 0)))
show me the meetings with the latest end times	 (listValue (superlative (getProperty (singleton en.meeting) (string !type)) (string max) (ensureNumericProperty (string end_time))))
what meeting ends earlier than 10am or 3pm	 (listValue (filter (getProperty (singleton en.meeting) (string !type)) (ensureNumericProperty (string end_time)) (string <) (ensureNumericEntity (concat (time 10 0) (time 15 0)))))
show me meetings that end before the weekly standup	 (listValue (filter (getProperty (singleton en.meeting) (string !type)) (ensureNumericProperty (string end_time)) (string <=) (ensureNumericEntity (getProperty en.meeting.weekly_standup (string end_time)))))
what meeting has the longest time	 (listValue (superlative (getProperty (singleton en.meeting) (string !type)) (string max) (ensureNumericProperty (string end_time))))
meetings that are attended by people that also attend the weekly standup meeting	 (listValue (filter (getProperty (singleton en.meeting) (string !type)) (string attendee) (string =) (filter (getProperty (singleton en.person) (string !type)) (reverse (string attendee)) (string =) en.meeting.weekly_standup)))
what important meeting has alice attending	 (listValue (filter (filter (getProperty (singleton en.meeting) (string !type)) (string is_important)) (string attendee) (string =) en.person.alice))
which meetings are held at greenberg cafe	 (listValue (filter (getProperty (singleton en.meeting) (string !type)) (string location) (string =) en.location.greenberg_cafe))
show me all meetings which happened at the same location as the least number of meetings	 (listValue (countSuperlative (getProperty (singleton en.location) (string !type)) (string min) (reverse (string location)) (getProperty (singleton en.meeting) (string !type))))
meeting ends at least at start time of weekly roundup	 (listValue (filter (getProperty (singleton en.meeting) (string !type)) (ensureNumericProperty (string end_time)) (string >=) (ensureNumericEntity (getProperty en.meeting.weekly_standup (string start_time)))))
show me all meetings on the same day as the weekly standup meeting	 (listValue (filter (getProperty (singleton en.meeting) (string !type)) (string date) (string =) (getProperty en.meeting.weekly_standup (string date))))
what meeting ended after 10am	 (listValue (filter (getProperty (singleton en.meeting) (string !type)) (ensureNumericProperty (string end_time)) (string >) (ensureNumericEntity (time 10 0))))
which meetings are significant	 (listValue (filter (getProperty (singleton en.meeting) (string !type)) (string is_important)))
show me all meetings happening later than 10 am or 3 pm	 (listValue (filter (getProperty (singleton en.meeting) (string !type)) (ensureNumericProperty (string start_time)) (string >) (ensureNumericEntity (concat (time 10 0) (time 15 0)))))
show me all people attending either the weekly standup meeting or annual review	 (listValue (filter (getProperty (singleton en.person) (string !type)) (reverse (string attendee)) (string =) (concat en.meeting.weekly_standup en.meeting.annual_review)))
show me meetings at greenberg cafe on jan 2	 (listValue (filter (filter (getProperty (singleton en.meeting) (string !type)) (string location) (string =) en.location.greenberg_cafe) (string date) (string =) (date 2015 1 2)))
show me the locations which have the most number of meetings	 (listValue (countSuperlative (getProperty (singleton en.location) (string !type)) (string max) (reverse (string location)) (getProperty (singleton en.meeting) (string !type))))
meeting starts later than 10am	 (listValue (filter (getProperty (singleton en.meeting) (string !type)) (ensureNumericProperty (string start_time)) (string >) (ensureNumericEntity (time 10 0))))
which meeting is scheduled on the latest date	 (listValue (superlative (getProperty (singleton en.meeting) (string !type)) (string max) (ensureNumericProperty (string date))))
meetings that are three hours long	 (listValue (filter (getProperty (singleton en.meeting) (string !type)) (string length) (string =) (number 3 en.hour)))
show me all meetings three hours long happening at the greenberg cafe	 (listValue (filter (filter (getProperty (singleton en.meeting) (string !type)) (string location) (string =) en.location.greenberg_cafe) (string length) (string =) (number 3 en.hour)))
what location is not the same as weekly standup	 (listValue (filter (getProperty (singleton en.location) (string !type)) (reverse (string location)) (string !=) en.meeting.weekly_standup))
meeting which starts at 10 am on jan 2	 (listValue (filter (filter (getProperty (singleton en.meeting) (string !type)) (string date) (string =) (date 2015 1 2)) (string start_time) (string =) (time 10 0)))
meetings on january 2 that alice attends	 (listValue (filter (filter (getProperty (singleton en.meeting) (string !type)) (string date) (string =) (date 2015 1 2)) (string attendee) (string =) en.person.alice))
what meeting has a location at greenberg cafe and starts at 10am	 (listValue (filter (filter (getProperty (singleton en.meeting) (string !type)) (string location) (string =) en.location.greenberg_cafe) (string start_time) (string =) (time 10 0)))
which meetings are scheduled to end at 10am	 (listValue (filter (getProperty (singleton en.meeting) (string !type)) (string end_time) (string =) (time 10 0)))
show me meetings that start and end at 10am	 (listValue (filter (filter (getProperty (singleton en.meeting) (string !type)) (string end_time) (string =) (time 10 0)) (string start_time) (string =) (time 10 0)))
what is the location of the jan 2 meeting	 (listValue (filter (getProperty (singleton en.location) (string !type)) (reverse (string location)) (string =) (filter (getProperty (singleton en.meeting) (string !type)) (string date) (string =) (date 2015 1 2))))
what meeting starts at 10am on jan 2	 (listValue (filter (filter (getProperty (singleton en.meeting) (string !type)) (string start_time) (string =) (time 10 0)) (string date) (string =) (date 2015 1 2)))
important meeting	 (listValue (filter (getProperty (singleton en.meeting) (string !type)) (string is_important)))
meetings that start after 10am or after 3pm	 (listValue (filter (getProperty (singleton en.meeting) (string !type)) (ensureNumericProperty (string start_time)) (string >) (ensureNumericEntity (concat (time 10 0) (time 15 0)))))
meetings that end later than the weekly standup meeting	 (listValue (filter (getProperty (singleton en.meeting) (string !type)) (ensureNumericProperty (string end_time)) (string >) (ensureNumericEntity (getProperty en.meeting.weekly_standup (string end_time)))))
people attending meetings that start at 10 am	 (listValue (filter (getProperty (singleton en.person) (string !type)) (reverse (string attendee)) (string =) (filter (getProperty (singleton en.meeting) (string !type)) (string start_time) (string =) (time 10 0))))
meeting which starts at 1000 am	 (listValue (filter (filter (getProperty (singleton en.meeting) (string !type)) (string start_time) (string =) (time 10 0)) (string start_time) (string =) (time 10 0)))
what is the average length of all the meetings	 (listValue (aggregate (string avg) (getProperty (getProperty (singleton en.meeting) (string !type)) (string length))))
what meeting has two attendees or less	 (listValue (countComparative (getProperty (singleton en.meeting) (string !type)) (string attendee) (string <=) (number 2)))
show me all meetings shorter than three hours	 (listValue (filter (getProperty (singleton en.meeting) (string !type)) (ensureNumericProperty (string length)) (string <) (ensureNumericEntity (number 3 en.hour))))
what meeting ends at the start or after the start of weekly standup	 (listValue (filter (getProperty (singleton en.meeting) (string !type)) (ensureNumericProperty (string end_time)) (string >=) (ensureNumericEntity (getProperty en.meeting.weekly_standup (string start_time)))))
what person attended weekly standup	 (listValue (filter (filter (getProperty (singleton en.person) (string !type)) (reverse (string attendee)) (string =) en.meeting.weekly_standup) (reverse (string attendee)) (string =) en.meeting.weekly_standup))
what meeting has an end time of 10am on jan2	 (listValue (filter (filter (getProperty (singleton en.meeting) (string !type)) (string end_time) (string =) (time 10 0)) (string date) (string =) (date 2015 1 2)))
meetings that are not on january 2	 (listValue (filter (getProperty (singleton en.meeting) (string !type)) (string date) (string !=) (date 2015 1 2)))
meetings that are three hours long and end at 10am	 (listValue (filter (filter (getProperty (singleton en.meeting) (string !type)) (string end_time) (string =) (time 10 0)) (string length) (string =) (number 3 en.hour)))
what meeting ends no later than 10am or 3pm	 (listValue (filter (getProperty (singleton en.meeting) (string !type)) (ensureNumericProperty (string end_time)) (string <=) (ensureNumericEntity (concat (time 10 0) (time 15 0)))))
meetings that are three hours long that start at 10am	 (listValue (filter (filter (getProperty (singleton en.meeting) (string !type)) (string start_time) (string =) (time 10 0)) (string length) (string =) (number 3 en.hour)))
meeting at greenberg cafe which ends at 10 am	 (listValue (filter (filter (getProperty (singleton en.meeting) (string !type)) (string end_time) (string =) (time 10 0)) (string location) (string =) en.location.greenberg_cafe))
what meeting is at least three hours	 (listValue (filter (getProperty (singleton en.meeting) (string !type)) (ensureNumericProperty (string length)) (string >=) (ensureNumericEntity (number 3 en.hour))))
where is the important meeting being held	 (listValue (filter (getProperty (singleton en.location) (string !type)) (reverse (string location)) (string =) (filter (getProperty (singleton en.meeting) (string !type)) (string is_important))))
what meeting start time is at the end of weekly standup	 (listValue (filter (getProperty (singleton en.meeting) (string !type)) (ensureNumericProperty (string start_time)) (string <=) (ensureNumericEntity (getProperty en.meeting.weekly_standup (string end_time)))))
which meetings will take as much time as weekly standup	 (listValue (filter (getProperty (singleton en.meeting) (string !type)) (ensureNumericProperty (string length)) (string >=) (ensureNumericEntity (getProperty en.meeting.weekly_standup (string length)))))
meeting which starts before the start time of weekly standup	 (listValue (filter (getProperty (singleton en.meeting) (string !type)) (ensureNumericProperty (string start_time)) (string >=) (ensureNumericEntity (getProperty en.meeting.weekly_standup (string start_time)))))
show me all meetings that alice is attending	 (listValue (filter (filter (getProperty (singleton en.meeting) (string !type)) (string attendee) (string =) en.person.alice) (string attendee) (string =) en.person.alice))
meeting is at least 3 hours long	 (listValue (filter (getProperty (singleton en.meeting) (string !type)) (ensureNumericProperty (string length)) (string >=) (ensureNumericEntity (number 3 en.hour))))
meeting starts no later than start time of weekly standup	 (listValue (filter (getProperty (singleton en.meeting) (string !type)) (ensureNumericProperty (string start_time)) (string <=) (ensureNumericEntity (getProperty en.meeting.weekly_standup (string start_time)))))
meetings attended by the smallest number of people	 (listValue (countSuperlative (getProperty (singleton en.meeting) (string !type)) (string min) (string attendee)))
location is same as the location of three hours long meeting	 (listValue (filter (getProperty (singleton en.location) (string !type)) (reverse (string location)) (string =) (filter (getProperty (singleton en.meeting) (string !type)) (string length) (string =) (number 3 en.hour))))
meetings held before january 2	 (listValue (filter (getProperty (singleton en.meeting) (string !type)) (ensureNumericProperty (string date)) (string <) (ensureNumericEntity (date 2015 1 2))))
show me all attendees of meetings ending at 10 am	 (listValue (filter (getProperty (singleton en.person) (string !type)) (reverse (string attendee)) (string =) (filter (getProperty (singleton en.meeting) (string !type)) (string end_time) (string =) (time 10 0))))
show me meetings that start before the weekly standup ends	 (listValue (filter (getProperty (singleton en.meeting) (string !type)) (ensureNumericProperty (string start_time)) (string >=) (ensureNumericEntity (getProperty en.meeting.weekly_standup (string end_time)))))
what meeting is on jan 2 at 10am	 (listValue (filter (filter (getProperty (singleton en.meeting) (string !type)) (string date) (string =) (date 2015 1 2)) (string start_time) (string =) (time 10 0)))
person who attends important meeting	 (listValue (filter (getProperty (singleton en.person) (string !type)) (reverse (string attendee)) (string =) (filter (getProperty (singleton en.meeting) (string !type)) (string is_important))))
show me all meetings which begin at the same time the weekly standup ends	 (listValue (filter (getProperty (singleton en.meeting) (string !type)) (string start_time) (string =) (getProperty en.meeting.weekly_standup (string end_time))))
what meeting is not three hours	 (listValue (filter (getProperty (singleton en.meeting) (string !type)) (string length) (string !=) (number 3 en.hour)))
person attending the most meetings	 (listValue (countSuperlative (getProperty (singleton en.person) (string !type)) (string max) (reverse (string attendee)) (getProperty (singleton en.meeting) (string !type))))
meeting that ends at end time of weekly standup	 (listValue (filter (getProperty (singleton en.meeting) (string !type)) (string end_time) (string =) (getProperty en.meeting.weekly_standup (string end_time))))
where will weekly standup and annual review take place	 (listValue (filter (getProperty (singleton en.location) (string !type)) (reverse (string location)) (string =) (concat en.meeting.weekly_standup en.meeting.annual_review)))
show me three hour meetings on jan 2	 (listValue (filter (filter (getProperty (singleton en.meeting) (string !type)) (string length) (string =) (number 3 en.hour)) (string date) (string =) (date 2015 1 2)))
meetings that start at or before 10am	 (listValue (filter (getProperty (singleton en.meeting) (string !type)) (ensureNumericProperty (string start_time)) (string <=) (ensureNumericEntity (time 10 0))))
what meeting is at greenberg cafe and alice is attending	 (listValue (filter (filter (getProperty (singleton en.meeting) (string !type)) (string location) (string =) en.location.greenberg_cafe) (string attendee) (string =) en.person.alice))
what meeting ends ealiest in the day	 (listValue (superlative (getProperty (singleton en.meeting) (string !type)) (string min) (ensureNumericProperty (string end_time))))
location different from location of weekly standup	 (listValue (filter (getProperty (singleton en.location) (string !type)) (reverse (string location)) (string !=) en.meeting.weekly_standup))
show me all meetings ending before 10 am	 (listValue (filter (getProperty (singleton en.meeting) (string !type)) (ensureNumericProperty (string end_time)) (string <) (ensureNumericEntity (time 10 0))))
meetings held in two or fewer locations	 (listValue (countComparative (getProperty (singleton en.meeting) (string !type)) (string location) (string <=) (number 2)))
what meetings are imporant and start at 10am	 (listValue (filter (filter (getProperty (singleton en.meeting) (string !type)) (string start_time) (string =) (time 10 0)) (string is_important)))
meetings that are three hours or less or one hour or less	 (listValue (filter (getProperty (singleton en.meeting) (string !type)) (ensureNumericProperty (string length)) (string <=) (ensureNumericEntity (concat (number 3 en.hour) (number 1 en.hour)))))
locations that house meetings on january 2	 (listValue (filter (getProperty (singleton en.location) (string !type)) (reverse (string location)) (string =) (filter (getProperty (singleton en.meeting) (string !type)) (string date) (string =) (date 2015 1 2))))
show me all meetings starting earlier than 10 am	 (listValue (filter (getProperty (singleton en.meeting) (string !type)) (ensureNumericProperty (string start_time)) (string <) (ensureNumericEntity (time 10 0))))
meetings that end at the same time as or later than the start of the weekly standup meeting	 (listValue (filter (getProperty (singleton en.meeting) (string !type)) (ensureNumericProperty (string end_time)) (string >=) (ensureNumericEntity (getProperty en.meeting.weekly_standup (string start_time)))))
which meetings in greenberg cafe will last three hours	 (listValue (filter (filter (getProperty (singleton en.meeting) (string !type)) (string location) (string =) en.location.greenberg_cafe) (string length) (string =) (number 3 en.hour)))
location is greenberg cafe or central office	 (listValue (concat en.location.greenberg_cafe en.location.central_office))
people that attend at least two meetings	 (listValue (countComparative (getProperty (singleton en.person) (string !type)) (reverse (string attendee)) (string >=) (number 2) (getProperty (singleton en.meeting) (string !type))))
places that house at least one meeting	 (listValue (countSuperlative (getProperty (singleton en.location) (string !type)) (string min) (reverse (string location)) (getProperty (singleton en.meeting) (string !type))))
meeting which starts at 1000 am at greenberg cafe	 (listValue (filter (filter (getProperty (singleton en.meeting) (string !type)) (string start_time) (string =) (time 10 0)) (string location) (string =) en.location.greenberg_cafe))
meeting at a single location	 (listValue (countComparative (getProperty (singleton en.meeting) (string !type)) (string location) (string <) (number 2)))
meetings that end at or before 10am	 (listValue (filter (getProperty (singleton en.meeting) (string !type)) (ensureNumericProperty (string end_time)) (string <=) (ensureNumericEntity (time 10 0))))
show me all meetings located at greenberg cafe	 (listValue (filter (filter (getProperty (singleton en.meeting) (string !type)) (string location) (string =) en.location.greenberg_cafe) (string location) (string =) en.location.greenberg_cafe))
meetings that end at the time when the weekly standup meeting starts	 (listValue (filter (getProperty (singleton en.meeting) (string !type)) (string end_time) (string =) (getProperty en.meeting.weekly_standup (string start_time))))
what meetings run for the shortest length of time	 (listValue (superlative (getProperty (singleton en.meeting) (string !type)) (string min) (ensureNumericProperty (string length))))
she me all meetings with a duration between 1 and 3 hours	 (listValue (filter (getProperty (singleton en.meeting) (string !type)) (ensureNumericProperty (string length)) (string <=) (ensureNumericEntity (concat (number 3 en.hour) (number 1 en.hour)))))
what meeting has fan end time after 10am or 3pm	 (listValue (filter (getProperty (singleton en.meeting) (string !type)) (ensureNumericProperty (string end_time)) (string >) (ensureNumericEntity (concat (time 10 0) (time 15 0)))))
show me all meetings three hours long which end at 10 am	 (listValue (filter (filter (getProperty (singleton en.meeting) (string !type)) (string length) (string =) (number 3 en.hour)) (string end_time) (string =) (time 10 0)))
locations of meetings that are three hours long	 (listValue (filter (getProperty (singleton en.location) (string !type)) (reverse (string location)) (string =) (filter (getProperty (singleton en.meeting) (string !type)) (string length) (string =) (number 3 en.hour))))
what person attends most meetings	 (listValue (countSuperlative (getProperty (singleton en.person) (string !type)) (string max) (reverse (string attendee)) (getProperty (singleton en.meeting) (string !type))))
meetings that end before 10 am or before 3pm	 (listValue (filter (getProperty (singleton en.meeting) (string !type)) (ensureNumericProperty (string end_time)) (string <) (ensureNumericEntity (concat (time 10 0) (time 15 0)))))
show me all important meetings that alice is attending	 (listValue (filter (filter (getProperty (singleton en.meeting) (string !type)) (string attendee) (string =) en.person.alice) (string is_important)))
what location is weekly standup and annual review	 (listValue (filter (getProperty (singleton en.location) (string !type)) (reverse (string location)) (string =) (concat en.meeting.weekly_standup en.meeting.annual_review)))
person attending same meeting as alice	 (listValue (filter (getProperty (singleton en.person) (string !type)) (reverse (string attendee)) (string =) (filter (getProperty (singleton en.meeting) (string !type)) (string attendee) (string =) en.person.alice)))
who is attending the meeting that ends at 10am	 (listValue (filter (getProperty (singleton en.person) (string !type)) (reverse (string attendee)) (string =) (filter (getProperty (singleton en.meeting) (string !type)) (string end_time) (string =) (time 10 0))))
show me all meetings that end at 10am	 (listValue (filter (filter (getProperty (singleton en.meeting) (string !type)) (string end_time) (string =) (time 10 0)) (string end_time) (string =) (time 10 0)))
meeting that does not end at 10am	 (listValue (filter (getProperty (singleton en.meeting) (string !type)) (string end_time) (string !=) (time 10 0)))
show me all meetings ending at the same time or later than the weekly standup meeting ends	 (listValue (filter (getProperty (singleton en.meeting) (string !type)) (ensureNumericProperty (string end_time)) (string >=) (ensureNumericEntity (getProperty en.meeting.weekly_standup (string end_time)))))
show me all meetings which end later than the weekly standup begins	 (listValue (filter (getProperty (singleton en.meeting) (string !type)) (ensureNumericProperty (string end_time)) (string >) (ensureNumericEntity (getProperty en.meeting.weekly_standup (string start_time)))))
meeting that starts no later than end time of weekly standup	 (listValue (filter (getProperty (singleton en.meeting) (string !type)) (ensureNumericProperty (string start_time)) (string <=) (ensureNumericEntity (getProperty en.meeting.weekly_standup (string end_time)))))
what meeting ends 10am or later	 (listValue (filter (getProperty (singleton en.meeting) (string !type)) (ensureNumericProperty (string end_time)) (string >=) (ensureNumericEntity (concat (time 10 0) (time 15 0)))))
what is the most recent meeting	 (listValue (superlative (getProperty (singleton en.meeting) (string !type)) (string max) (ensureNumericProperty (string date))))
what meeting has a date after jan 2	 (listValue (filter (getProperty (singleton en.meeting) (string !type)) (ensureNumericProperty (string date)) (string >) (ensureNumericEntity (date 2015 1 2))))
show me where the weekly standup and annual review is happening	 (listValue (filter (getProperty (singleton en.location) (string !type)) (reverse (string location)) (string =) (concat en.meeting.weekly_standup en.meeting.annual_review)))
person attending three hour meeting	 (listValue (filter (getProperty (singleton en.person) (string !type)) (reverse (string attendee)) (string =) (filter (getProperty (singleton en.meeting) (string !type)) (string length) (string =) (number 3 en.hour))))
what meeting has a date of jan 2 at greenberg cafe	 (listValue (filter (filter (getProperty (singleton en.meeting) (string !type)) (string date) (string =) (date 2015 1 2)) (string location) (string =) en.location.greenberg_cafe))
which meetings will be longer than weekly standup	 (listValue (filter (getProperty (singleton en.meeting) (string !type)) (ensureNumericProperty (string length)) (string >) (ensureNumericEntity (getProperty en.meeting.weekly_standup (string length)))))
show me all meetings on january 2nd at the greenberg cafe	 (listValue (filter (filter (getProperty (singleton en.meeting) (string !type)) (string date) (string =) (date 2015 1 2)) (string location) (string =) en.location.greenberg_cafe))
shortest meeting	 (listValue (superlative (getProperty (singleton en.meeting) (string !type)) (string min) (ensureNumericProperty (string length))))
meetings held in the same place as the weekly standup meeting	 (listValue (filter (getProperty (singleton en.meeting) (string !type)) (string location) (string =) (filter (getProperty (singleton en.location) (string !type)) (reverse (string location)) (string =) en.meeting.weekly_standup)))
what meeting did alice attend at the greenberg cafe	 (listValue (filter (filter (getProperty (singleton en.meeting) (string !type)) (string location) (string =) en.location.greenberg_cafe) (string attendee) (string =) en.person.alice))
what meeting has a location at greeberg cafe on jan 2	 (listValue (filter (filter (getProperty (singleton en.meeting) (string !type)) (string location) (string =) en.location.greenberg_cafe) (string date) (string =) (date 2015 1 2)))
show me the meetings which have lasted the longest	 (listValue (superlative (getProperty (singleton en.meeting) (string !type)) (string max) (ensureNumericProperty (string length))))
show me all meetings that end by 10am	 (listValue (filter (getProperty (singleton en.meeting) (string !type)) (ensureNumericProperty (string end_time)) (string >=) (ensureNumericEntity (time 10 0))))
what meetings have the same duration as the weekly stand up meeting	 (listValue (filter (getProperty (singleton en.meeting) (string !type)) (string length) (string =) (getProperty en.meeting.weekly_standup (string length))))
meeting share attendee with weekly standup	 (listValue (filter (getProperty (singleton en.meeting) (string !type)) (string attendee) (string =) (getProperty en.meeting.weekly_standup (string attendee))))
weekly standup date	 (listValue (getProperty en.meeting.weekly_standup (string date)))
what meetings are scheduled to run for 3 hours	 (listValue (filter (getProperty (singleton en.meeting) (string !type)) (ensureNumericProperty (string length)) (string >=) (ensureNumericEntity (number 3 en.hour))))
show me all meetings at least one hour or three hours long	 (listValue (filter (getProperty (singleton en.meeting) (string !type)) (ensureNumericProperty (string length)) (string >=) (ensureNumericEntity (concat (number 3 en.hour) (number 1 en.hour)))))
what three hour meeting is on jan 2	 (listValue (filter (filter (getProperty (singleton en.meeting) (string !type)) (string date) (string =) (date 2015 1 2)) (string length) (string =) (number 3 en.hour)))
what location does not hold the weekly standup meeting	 (listValue (filter (getProperty (singleton en.location) (string !type)) (reverse (string location)) (string !=) en.meeting.weekly_standup))
meeting that starts at 10am and ends at 1pm	 (listValue (filter (filter (getProperty (singleton en.meeting) (string !type)) (string length) (string =) (number 3 en.hour)) (string start_time) (string =) (time 10 0)))
how many attendees are there for this meeting	 (listValue (call .size (getProperty (singleton en.person) (string !type))))
what is the meeting that starts at 10 am in greenberg cafe	 (listValue (filter (filter (getProperty (singleton en.meeting) (string !type)) (string location) (string =) en.location.greenberg_cafe) (string start_time) (string =) (time 10 0)))
meetings that end at or after 10 am or at or after 3pm	 (listValue (filter (getProperty (singleton en.meeting) (string !type)) (ensureNumericProperty (string end_time)) (string >=) (ensureNumericEntity (concat (time 10 0) (time 15 0)))))
what meeting is at the same location as weekly standup	 (listValue (filter (getProperty (singleton en.meeting) (string !type)) (string location) (string =) (getProperty en.meeting.weekly_standup (string location))))
meeting which has shortest start time	 (listValue (superlative (getProperty (singleton en.meeting) (string !type)) (string min) (ensureNumericProperty (string start_time))))
what meeting is on jan 2 or 3rd	 (listValue (filter (getProperty (singleton en.meeting) (string !type)) (string date) (string =) (concat (date 2015 1 2) (date 2015 1 3))))
meetings that end earlier than the weekly standup meeting	 (listValue (filter (getProperty (singleton en.meeting) (string !type)) (ensureNumericProperty (string end_time)) (string <) (ensureNumericEntity (getProperty en.meeting.weekly_standup (string end_time)))))
show me all meetings ending at 10 am or 3 pm	 (listValue (filter (getProperty (singleton en.meeting) (string !type)) (string end_time) (string =) (concat (time 10 0) (time 15 0))))
show me all of the people who did not attend the weekly standup meeting	 (listValue (filter (getProperty (singleton en.person) (string !type)) (reverse (string attendee)) (string !=) en.meeting.weekly_standup))
meetings that are the same length as or longer than the weekly standup meeting	 (listValue (filter (getProperty (singleton en.meeting) (string !type)) (ensureNumericProperty (string length)) (string >=) (ensureNumericEntity (getProperty en.meeting.weekly_standup (string length)))))
show me all meetings which are exactly one hour or exactly three hours long	 (listValue (filter (getProperty (singleton en.meeting) (string !type)) (string length) (string =) (concat (number 3 en.hour) (number 1 en.hour))))
what is the location of the important meeting	 (listValue (filter (getProperty (singleton en.location) (string !type)) (reverse (string location)) (string =) (filter (getProperty (singleton en.meeting) (string !type)) (string is_important))))
which meetings end later in the day than weekly standup	 (listValue (filter (getProperty (singleton en.meeting) (string !type)) (ensureNumericProperty (string end_time)) (string >) (ensureNumericEntity (getProperty en.meeting.weekly_standup (string end_time)))))
show me all meetings which end at the same time as the weekly standup ends	 (listValue (filter (getProperty (singleton en.meeting) (string !type)) (string end_time) (string =) (getProperty en.meeting.weekly_standup (string end_time))))
what location are the fewest meetings held	 (listValue (countSuperlative (getProperty (singleton en.location) (string !type)) (string min) (reverse (string location)) (getProperty (singleton en.meeting) (string !type))))
show me all meetings happening after january 2nd or january 3rd	 (listValue (filter (getProperty (singleton en.meeting) (string !type)) (ensureNumericProperty (string date)) (string >) (ensureNumericEntity (concat (date 2015 1 2) (date 2015 1 3)))))
meetings that end later than 10am or later than 3pm	 (listValue (filter (getProperty (singleton en.meeting) (string !type)) (ensureNumericProperty (string end_time)) (string >) (ensureNumericEntity (concat (time 10 0) (time 15 0)))))
meetings that start before the weekly standup meeting ends	 (listValue (filter (getProperty (singleton en.meeting) (string !type)) (ensureNumericProperty (string start_time)) (string <) (ensureNumericEntity (getProperty en.meeting.weekly_standup (string end_time)))))
show me all meetings with two attendees	 (listValue (countComparative (getProperty (singleton en.meeting) (string !type)) (string attendee) (string =) (number 2)))
which meetings are important	 (listValue (filter (filter (getProperty (singleton en.meeting) (string !type)) (string is_important)) (string is_important)))
who is attending weekly standup	 (listValue (getProperty en.meeting.weekly_standup (string attendee)))
show me meetings ending at 10am in greenberg cafe	 (listValue (filter (filter (getProperty (singleton en.meeting) (string !type)) (string end_time) (string =) (time 10 0)) (string location) (string =) en.location.greenberg_cafe))
show me all important meetings that end at 10am	 (listValue (filter (filter (getProperty (singleton en.meeting) (string !type)) (string is_important)) (string end_time) (string =) (time 10 0)))
location is same as location of meeting ends at 10 am	 (listValue (filter (getProperty (singleton en.location) (string !type)) (reverse (string location)) (string =) (filter (getProperty (singleton en.meeting) (string !type)) (string end_time) (string =) (time 10 0))))
meetings attended by alice or bob	 (listValue (filter (getProperty (singleton en.meeting) (string !type)) (string attendee) (string =) (concat en.person.alice en.person.bob)))
show me meetings for jan 2	 (listValue (filter (getProperty (singleton en.meeting) (string !type)) (string date) (string =) (date 2015 1 2)))
show me the meeting which has happened at the most locations	 (listValue (countSuperlative (getProperty (singleton en.meeting) (string !type)) (string max) (string location)))
show me meeting locations with alice	 (listValue (filter (getProperty (singleton en.location) (string !type)) (reverse (string location)) (string =) (filter (getProperty (singleton en.meeting) (string !type)) (string attendee) (string =) en.person.alice)))
show me all three hour meetings that are important	 (listValue (filter (filter (getProperty (singleton en.meeting) (string !type)) (string length) (string =) (number 3 en.hour)) (string is_important)))
meeting with least attendees	 (listValue (countSuperlative (getProperty (singleton en.meeting) (string !type)) (string min) (string attendee)))
show me all meetings attended by alice which are three hours long	 (listValue (filter (filter (getProperty (singleton en.meeting) (string !type)) (string attendee) (string =) en.person.alice) (string length) (string =) (number 3 en.hour)))
what person is attending the meeting that starts at 10am	 (listValue (filter (getProperty (singleton en.person) (string !type)) (reverse (string attendee)) (string =) (filter (getProperty (singleton en.meeting) (string !type)) (string start_time) (string =) (time 10 0))))
what three hour meeting starts at 10am	 (listValue (filter (filter (getProperty (singleton en.meeting) (string !type)) (string start_time) (string =) (time 10 0)) (string length) (string =) (number 3 en.hour)))
when is weekly standup or annual review	 (listValue (concat en.meeting.weekly_standup en.meeting.annual_review))
who is attending the same meeting as alice	 (listValue (filter (getProperty (singleton en.person) (string !type)) (reverse (string attendee)) (string =) (filter (getProperty (singleton en.meeting) (string !type)) (string attendee) (string =) en.person.alice)))
show me important meetings	 (listValue (filter (filter (getProperty (singleton en.meeting) (string !type)) (string is_important)) (string is_important)))
meeting ends no later than 10am or 3pm	 (listValue (filter (getProperty (singleton en.meeting) (string !type)) (ensureNumericProperty (string end_time)) (string <=) (ensureNumericEntity (concat (time 10 0) (time 15 0)))))
show me meetings with the most locations	 (listValue (countSuperlative (getProperty (singleton en.meeting) (string !type)) (string max) (string location)))
meeting that has maximum 2 attendees	 (listValue (countComparative (getProperty (singleton en.meeting) (string !type)) (string attendee) (string <=) (number 2)))
person attending at least two meetings	 (listValue (countComparative (getProperty (singleton en.person) (string !type)) (reverse (string attendee)) (string >=) (number 2) (getProperty (singleton en.meeting) (string !type))))
what important meeting has a length of three hours	 (listValue (filter (filter (getProperty (singleton en.meeting) (string !type)) (string is_important)) (string length) (string =) (number 3 en.hour)))
show me all meetings that start at 10am and last three hours	 (listValue (filter (filter (getProperty (singleton en.meeting) (string !type)) (string start_time) (string =) (time 10 0)) (string length) (string =) (number 3 en.hour)))
where is my jan 2 meeting	 (listValue (filter (getProperty (singleton en.location) (string !type)) (reverse (string location)) (string =) (filter (getProperty (singleton en.meeting) (string !type)) (string date) (string =) (date 2015 1 2))))
meeting starts at 10am or 3pm at the earliest	 (listValue (filter (getProperty (singleton en.meeting) (string !type)) (ensureNumericProperty (string start_time)) (string <=) (ensureNumericEntity (concat (time 10 0) (time 15 0)))))
what time does the weekly standup meeting end	 (listValue (getProperty en.meeting.weekly_standup (string end_time)))
jan 2nd meeting with alice as attendee	 (listValue (filter (filter (getProperty (singleton en.meeting) (string !type)) (string date) (string =) (date 2015 1 2)) (string attendee) (string =) en.person.alice))
who has attended the least meetings	 (listValue (countSuperlative (getProperty (singleton en.person) (string !type)) (string min) (reverse (string attendee)) (getProperty (singleton en.meeting) (string !type))))
show me all meetings that start no earlier than 10am	 (listValue (filter (getProperty (singleton en.meeting) (string !type)) (ensureNumericProperty (string start_time)) (string >=) (ensureNumericEntity (time 10 0))))
what is the location of the meeting that will have two or more attendees	 (listValue (countComparative (getProperty (singleton en.location) (string !type)) (reverse (string location)) (string >=) (number 2) (getProperty (singleton en.meeting) (string !type))))
show me all meetings on january 2nd happening at the greenberg cafe	 (listValue (filter (filter (getProperty (singleton en.meeting) (string !type)) (string location) (string =) en.location.greenberg_cafe) (string date) (string =) (date 2015 1 2)))
meeting held in the fewest number of locations	 (listValue (countSuperlative (getProperty (singleton en.meeting) (string !type)) (string min) (string location)))
meeting in greenberg cafe or central office	 (listValue (filter (getProperty (singleton en.meeting) (string !type)) (string location) (string =) (concat en.location.greenberg_cafe en.location.central_office)))
meeting featuring alice as attendee starting at 10am	 (listValue (filter (filter (getProperty (singleton en.meeting) (string !type)) (string start_time) (string =) (time 10 0)) (string attendee) (string =) en.person.alice))
show me any meetings scheduled to be longer than one hour or three hours	 (listValue (filter (getProperty (singleton en.meeting) (string !type)) (ensureNumericProperty (string length)) (string >) (ensureNumericEntity (concat (number 3 en.hour) (number 1 en.hour)))))
show me any meetings that alice or bob have attended	 (listValue (concat en.person.alice en.person.bob))
what meeting is as long or longer than weekly standup	 (listValue (filter (getProperty (singleton en.meeting) (string !type)) (ensureNumericProperty (string length)) (string >=) (ensureNumericEntity (getProperty en.meeting.weekly_standup (string length)))))
meeting with largest number of attendees	 (listValue (countSuperlative (getProperty (singleton en.meeting) (string !type)) (string max) (string attendee)))
what meeting has the same date as weekly startup	 (listValue (filter (getProperty (singleton en.meeting) (string !type)) (string date) (string =) (getProperty en.meeting.weekly_standup (string date))))
meeting later than january 2nd or 3rd	 (listValue (filter (getProperty (singleton en.meeting) (string !type)) (ensureNumericProperty (string date)) (string >) (ensureNumericEntity (concat (date 2015 1 2) (date 2015 1 3)))))
meeting that ends at start time of weekly standup	 (listValue (filter (getProperty (singleton en.meeting) (string !type)) (string end_time) (string =) (getProperty en.meeting.weekly_standup (string start_time))))
show me all meetings that end at 10am on jan 2	 (listValue (filter (filter (getProperty (singleton en.meeting) (string !type)) (string end_time) (string =) (time 10 0)) (string date) (string =) (date 2015 1 2)))
what meeting did alice not attend	 (listValue (filter (getProperty (singleton en.meeting) (string !type)) (string attendee) (string !=) en.person.alice))
what meeting is not located at greenberg cafe	 (listValue (filter (getProperty (singleton en.meeting) (string !type)) (string location) (string !=) en.location.greenberg_cafe))
show me all meetings beginning later than the weekly standup	 (listValue (filter (getProperty (singleton en.meeting) (string !type)) (ensureNumericProperty (string start_time)) (string >) (ensureNumericEntity (getProperty en.meeting.weekly_standup (string start_time)))))
what meeting does not start at 10am	 (listValue (filter (getProperty (singleton en.meeting) (string !type)) (string start_time) (string !=) (time 10 0)))
important meetings	 (listValue (filter (getProperty (singleton en.meeting) (string !type)) (string is_important)))
show all meetings that end at 10am on jan 2	 (listValue (filter (filter (getProperty (singleton en.meeting) (string !type)) (string date) (string =) (date 2015 1 2)) (string end_time) (string =) (time 10 0)))
meetings that start later than or at the same time as the weekly standup meeting	 (listValue (filter (getProperty (singleton en.meeting) (string !type)) (ensureNumericProperty (string start_time)) (string >=) (ensureNumericEntity (getProperty en.meeting.weekly_standup (string start_time)))))
show me all meetings ending at 10 am which are scheduled to be three hours long	 (listValue (filter (filter (getProperty (singleton en.meeting) (string !type)) (string end_time) (string =) (time 10 0)) (string length) (string =) (number 3 en.hour)))
meeting starts before weekly standup	 (listValue (filter (getProperty (singleton en.meeting) (string !type)) (ensureNumericProperty (string start_time)) (string <) (ensureNumericEntity (getProperty en.meeting.weekly_standup (string start_time)))))
what meeting has a date no later than jan 2	 (listValue (filter (getProperty (singleton en.meeting) (string !type)) (ensureNumericProperty (string date)) (string >=) (ensureNumericEntity (date 2015 1 2))))
which meeting is the shortest	 (listValue (superlative (getProperty (singleton en.meeting) (string !type)) (string min) (ensureNumericProperty (string length))))
where is the threehour long meeting	 (listValue (filter (getProperty (singleton en.location) (string !type)) (reverse (string location)) (string =) (filter (getProperty (singleton en.meeting) (string !type)) (string length) (string =) (number 3 en.hour))))
show me meetings starting later than 10am	 (listValue (filter (getProperty (singleton en.meeting) (string !type)) (ensureNumericProperty (string start_time)) (string >) (ensureNumericEntity (concat (time 10 0) (time 15 0)))))
show me all meetings the same length of the weekly standup	 (listValue (filter (getProperty (singleton en.meeting) (string !type)) (string length) (string =) (getProperty en.meeting.weekly_standup (string length))))
show me meeting which end before weekly standup	 (listValue (filter (getProperty (singleton en.meeting) (string !type)) (ensureNumericProperty (string end_time)) (string <=) (ensureNumericEntity (getProperty en.meeting.weekly_standup (string start_time)))))
meetings attended by alice that start at 10am	 (listValue (filter (filter (getProperty (singleton en.meeting) (string !type)) (string attendee) (string =) en.person.alice) (string start_time) (string =) (time 10 0)))
what meetings end at 10am or 3pm	 (listValue (filter (getProperty (singleton en.meeting) (string !type)) (string end_time) (string =) (concat (time 10 0) (time 15 0))))
show me all locations that are used for more than two meetings	 (listValue (countComparative (getProperty (singleton en.location) (string !type)) (reverse (string location)) (string >) (number 2) (getProperty (singleton en.meeting) (string !type))))
show me all meetings alice has attended which have ended at 10 am	 (listValue (filter (filter (getProperty (singleton en.meeting) (string !type)) (string attendee) (string =) en.person.alice) (string end_time) (string =) (time 10 0)))
show me all meetings less than three hours long	 (listValue (filter (getProperty (singleton en.meeting) (string !type)) (ensureNumericProperty (string length)) (string <=) (ensureNumericEntity (number 3 en.hour))))
show the meeting on jan 2	 (listValue (filter (getProperty (singleton en.meeting) (string !type)) (string date) (string =) (date 2015 1 2)))
show me all 3 hour meetings with alice	 (listValue (filter (filter (getProperty (singleton en.meeting) (string !type)) (string length) (string =) (number 3 en.hour)) (string attendee) (string =) en.person.alice))
show me all meetings starting at the same time as the weekly standup	 (listValue (filter (getProperty (singleton en.meeting) (string !type)) (string start_time) (string =) (getProperty en.meeting.weekly_standup (string start_time))))
show me all meetings the same length or longer than the weekly standup	 (listValue (filter (getProperty (singleton en.meeting) (string !type)) (ensureNumericProperty (string length)) (string >=) (ensureNumericEntity (getProperty en.meeting.weekly_standup (string length)))))
show me the locations of all meetings three hours in length	 (listValue (filter (getProperty (singleton en.location) (string !type)) (reverse (string location)) (string =) (filter (getProperty (singleton en.meeting) (string !type)) (string length) (string =) (number 3 en.hour))))
who are the attendees for fo the meetings in greenberg cafe	 (listValue (filter (getProperty (singleton en.person) (string !type)) (reverse (string attendee)) (string =) (filter (getProperty (singleton en.meeting) (string !type)) (string location) (string =) en.location.greenberg_cafe)))
show me all meetings with two or more people attending	 (listValue (countComparative (getProperty (singleton en.meeting) (string !type)) (string attendee) (string >=) (number 2)))
what meeting starts earlier than the end time of weekly standup	 (listValue (filter (getProperty (singleton en.meeting) (string !type)) (ensureNumericProperty (string start_time)) (string <) (ensureNumericEntity (getProperty en.meeting.weekly_standup (string end_time)))))
meetings that end the earliest	 (listValue (superlative (getProperty (singleton en.meeting) (string !type)) (string min) (ensureNumericProperty (string end_time))))
show me all meetings alice attended on january 2nd	 (listValue (filter (filter (getProperty (singleton en.meeting) (string !type)) (string attendee) (string =) en.person.alice) (string date) (string =) (date 2015 1 2)))
meetings on january 2	 (listValue (filter (getProperty (singleton en.meeting) (string !type)) (string date) (string =) (date 2015 1 2)))
which people will attend two or more meetings	 (listValue (countComparative (getProperty (singleton en.person) (string !type)) (reverse (string attendee)) (string >) (number 2) (getProperty (singleton en.meeting) (string !type))))
show meetings that end at 10am or 3pm	 (listValue (filter (getProperty (singleton en.meeting) (string !type)) (string end_time) (string =) (concat (time 10 0) (time 15 0))))
show me all meetings happening on january 2nd or january 3rd	 (listValue (filter (getProperty (singleton en.meeting) (string !type)) (string date) (string =) (concat (date 2015 1 2) (date 2015 1 3))))
show me all meetings beginning on or after january 2nd	 (listValue (filter (getProperty (singleton en.meeting) (string !type)) (ensureNumericProperty (string date)) (string >=) (ensureNumericEntity (concat (date 2015 1 2) (date 2015 1 3)))))
meeting whose location is same as the location of weekly standup	 (listValue (filter (getProperty (singleton en.meeting) (string !type)) (string location) (string =) (filter (getProperty (singleton en.location) (string !type)) (reverse (string location)) (string =) en.meeting.weekly_standup)))
show me the meetings scheduled earliest in the month	 (listValue (superlative (getProperty (singleton en.meeting) (string !type)) (string min) (ensureNumericProperty (string date))))
who is not an attendee of weekly standup	 (listValue (filter (getProperty (singleton en.person) (string !type)) (reverse (string attendee)) (string !=) en.meeting.weekly_standup))
what meeting is on jan 2 or earlier	 (listValue (filter (getProperty (singleton en.meeting) (string !type)) (ensureNumericProperty (string date)) (string <=) (ensureNumericEntity (date 2015 1 2))))
what location is the meeting that starts at 10am	 (listValue (filter (getProperty (singleton en.location) (string !type)) (reverse (string location)) (string =) (filter (getProperty (singleton en.meeting) (string !type)) (string start_time) (string =) (time 10 0))))
locations of the weekly standup meeting or annual review meeting	 (listValue (filter (getProperty (singleton en.location) (string !type)) (reverse (string location)) (string =) (concat en.meeting.weekly_standup en.meeting.annual_review)))
meetings attended by alice that are three hours long	 (listValue (filter (filter (getProperty (singleton en.meeting) (string !type)) (string attendee) (string =) en.person.alice) (string length) (string =) (number 3 en.hour)))
what are the areas where two or more meetings take place	 (listValue (countComparative (getProperty (singleton en.location) (string !type)) (reverse (string location)) (string >=) (number 2) (getProperty (singleton en.meeting) (string !type))))
show me all meetings that fall before or after jan 2	 (listValue (filter (getProperty (singleton en.meeting) (string !type)) (string date) (string !=) (date 2015 1 2)))
show me all meetings at the same location as the weekly standup	 (listValue (filter (getProperty (singleton en.meeting) (string !type)) (string location) (string =) (getProperty en.meeting.weekly_standup (string location))))
show me meetings that last three hours	 (listValue (filter (getProperty (singleton en.meeting) (string !type)) (string length) (string =) (number 3 en.hour)))
show me meeting locations that start at 10am	 (listValue (filter (getProperty (singleton en.location) (string !type)) (reverse (string location)) (string =) (filter (getProperty (singleton en.meeting) (string !type)) (string start_time) (string =) (time 10 0))))
show me locations with the fewest meetings	 (listValue (countSuperlative (getProperty (singleton en.location) (string !type)) (string min) (reverse (string location)) (getProperty (singleton en.meeting) (string !type))))
how many people attended meetings	 (listValue (call .size (getProperty (singleton en.person) (string !type))))
show me meetings with alice or bob	 (listValue (filter (getProperty (singleton en.meeting) (string !type)) (string attendee) (string =) (concat en.person.alice en.person.bob)))
show me all meetings happening on days other than january 2nd	 (listValue (filter (getProperty (singleton en.meeting) (string !type)) (string date) (string !=) (date 2015 1 2)))
show me all people who have attended at least two meetings	 (listValue (countComparative (getProperty (singleton en.person) (string !type)) (reverse (string attendee)) (string >=) (number 2) (getProperty (singleton en.meeting) (string !type))))
meetings that end at or after the weekly standup meeting ends	 (listValue (filter (getProperty (singleton en.meeting) (string !type)) (ensureNumericProperty (string end_time)) (string >=) (ensureNumericEntity (getProperty en.meeting.weekly_standup (string end_time)))))
